repository,package,total_commits,total_added,total_removed,total_churn,total_files,avg_churn_per_commit
camel,org.apache.camel.builder.endpoint.dsl,1876,940834,391501,1332335,1118,710.1998933901918
camel,org.apache.camel.builder.component.dsl,1175,229480,59137,288617,1148,245.63148936170214
camel,org.apache.camel.processor,2706,143811,48762,192573,1913,71.16518847006652
camel,org.apache.camel.impl,2706,97370,46103,143473,737,53.020325203252035
camel,org.apache.camel.model,1956,84127,45514,129641,697,66.27862985685071
camel,org.apache.camel.builder.endpoint,762,78148,46925,125073,88,164.13779527559055
camel,org.apache.camel.component.sql.stored.template.generated,78,55686,53533,109219,14,1400.2435897435898
camel,generated.java.org.apache.camel.builder.endpoint.dsl,70,0,108209,108209,89,1545.8428571428572
camel,org.apache.camel.component.file,1282,57332,28633,85965,571,67.05538221528862
camel,org.apache.camel.maven.packaging,1212,51145,34540,85685,94,70.69719471947195
camel,org.apache.camel.component.file.remote,877,55094,26662,81756,356,93.22234891676169
camel,org.apache.camel.component.jms,1096,55281,23525,78806,295,71.90328467153284
camel,org.apache.camel.main,1135,56436,20636,77072,263,67.90484581497797
camel,org.apache.camel.builder,1347,49602,27217,76819,336,57.02969561989607
camel,org.apache.camel.util,1700,55228,19809,75037,309,44.13941176470588
camel,org.apache.camel.management,1156,53392,19394,72786,803,62.963667820069205
camel,org.apache.camel.support,1229,48285,20130,68415,338,55.66720911310008
camel,org.apache.camel.component.hl7,126,49663,7861,57524,69,456.53968253968253
camel,org.apache.camel.builder.component,390,32787,23513,56300,7,144.35897435897436
camel,org.apache.camel,1783,39563,16076,55639,492,31.20527201346046
camel,org.apache.camel.impl.engine,1172,34356,20005,54361,250,46.38310580204778
camel,org.apache.camel.dsl.yaml.deserializers,400,39312,14220,53532,31,133.83
camel,org.apache.camel.maven,622,30966,19475,50441,132,81.09485530546624
camel,org.apache.camel.component.cxf,819,33003,16110,49113,255,59.967032967032964
camel,org.apache.camel.component.http,677,31539,16821,48360,194,71.4327917282127
camel,org.apache.camel.component.bean,778,31524,10915,42439,467,54.548843187660665
camel,org.apache.camel.spi,1273,31458,9882,41340,469,32.47446975648075
camel,org.apache.camel.component.jetty,778,27330,13129,40459,298,52.00385604113111
camel,org.apache.camel.model.dataformat,471,26784,11154,37938,241,80.54777070063695
camel,org.apache.camel.dsl.jbang.core.commands,869,24778,11506,36284,81,41.75373993095512
camel,org.apache.camel.component.mail,560,25556,9560,35116,148,62.707142857142856
camel,org.apache.camel.component.netty,402,21143,12692,33835,135,84.16666666666667
camel,org.apache.camel.component.kafka,539,22220,10445,32665,60,60.60296846011132
camel,org.apache.camel.component.netty.http,428,20575,10643,31218,186,72.9392523364486
camel,generated.java.org.apache.camel.builder.component.dsl,75,0,31212,31212,95,416.16
camel,org.apache.camel.issues,466,24587,6126,30713,407,65.9077253218884
camel,org.apache.camel.component.salesforce,349,21580,8830,30410,101,87.13467048710602
camel,org.apache.camel.component.netty4,190,22579,7477,30056,181,158.18947368421053
camel,org.apache.maven.plugins.javadoc,25,14171,14171,28342,3,1133.68
camel,org.apache.camel.management.mbean,747,20508,7098,27606,331,36.95582329317269
camel,org.apache.camel.component.mllp,171,20136,7388,27524,96,160.95906432748538
camel,org.apache.camel.component.debezium.configuration,59,18607,8711,27318,39,463.0169491525424
camel,org.apache.camel.spring,717,18588,8691,27279,188,38.04602510460251
camel,org.apache.camel.test.spring,123,15683,10518,26201,246,213.01626016260164
camel,org.apache.camel.catalog,339,17835,7161,24996,94,73.73451327433628
camel,org.apache.camel.component.smpp,237,17376,6821,24197,58,102.09704641350211
camel,org.apache.camel.component.debezium,98,17461,6015,23476,98,239.55102040816325
camel,org.apache.camel.component.google.drive,173,18072,5357,23429,135,135.4277456647399
camel,org.apache.camel.component.aws.s3,247,15735,7201,22936,82,92.8582995951417
camel,org.apache.camel.component.thrift.generated,11,15502,7297,22799,4,2072.6363636363635
camel,org.apache.camel.component.cxf.jaxrs,403,15857,6210,22067,125,54.75682382133995
camel,org.apache.camel.component.rabbitmq,264,12949,9062,22011,42,83.375
camel,org.apache.camel.processor.interceptor,413,14677,7327,22004,147,53.27845036319613
camel,org.apache.camel.cdi.test,60,15225,6146,21371,87,356.18333333333334
camel,org.apache.camel.component.mina,321,13257,7845,21102,100,65.73831775700934
camel,org.apache.camel.tools.apt,289,11412,9556,20968,36,72.55363321799308
camel,org.apache.camel.component.hdfs,176,10441,10500,20941,51,118.98295454545455
camel,org.apache.camel.xml.in,310,12564,8042,20606,9,66.47096774193548
camel,org.apache.camel.component.sql,293,15368,4888,20256,95,69.13310580204778
camel,org.apache.camel.component.restlet,326,13119,6720,19839,106,60.855828220858896
camel,org.apache.camel.component.fhir,129,14882,4670,19552,70,151.56589147286823
camel,org.apache.camel.component.aws.sqs,229,12386,6998,19384,76,84.646288209607
camel,org.apache.camel.reifier,338,13240,6127,19367,279,57.298816568047336
camel,org.apache.camel.component.properties,327,14662,4541,19203,204,58.72477064220183
camel,org.apache.camel.processor.aggregator,324,14882,4219,19101,234,58.9537037037037
camel,org.apache.camel.component.websocket,177,11671,7425,19096,54,107.88700564971751
camel,org.apache.camel.component.solr,146,12593,6278,18871,36,129.25342465753425
camel,org.apache.camel.dataformat.csv,131,11911,6949,18860,47,143.96946564885496
camel,org.apache.camel.itest.springboot,157,17377,1444,18821,333,119.87898089171975
camel,org.apache.camel.commands,146,9615,9118,18733,63,128.3082191780822
camel,org.apache.camel.language.simple,383,13365,4888,18253,96,47.65796344647519
camel,org.apache.camel.openapi,121,12113,6113,18226,45,150.62809917355372
camel,org.apache.camel.itest.karaf,401,14662,3561,18223,321,45.443890274314214
camel,org.apache.camel.cdi,166,9426,8716,18142,89,109.28915662650603
camel,org.apache.camel.component.box,152,12325,5650,17975,71,118.25657894736842
camel,org.apache.camel.component.sjms,219,11046,6846,17892,50,81.6986301369863
camel,org.apache.camel.component.twilio,88,13227,4080,17307,127,196.67045454545453
camel,org.apache.camel.processor.async,185,13003,4256,17259,209,93.2918918918919
camel,org.apache.camel.component.xmlsecurity,112,11330,5301,16631,24,148.49107142857142
camel,org.apache.camel.component.as2,145,12540,3789,16329,41,112.61379310344827
camel,org.apache.camel.component.mongodb,200,10446,5811,16257,49,81.285
camel,org.apache.camel.component.undertow,321,11769,4447,16216,66,50.517133956386296
camel,org.apache.camel.dataformat.bindy,194,9787,6283,16070,14,82.83505154639175
camel,org.apache.camel.dataformat.univocity,37,10140,5919,16059,33,434.02702702702703
camel,org.apache.camel.component.braintree,120,12025,4018,16043,86,133.69166666666666
camel,test.java.org.apache.camel.itest.springboot,42,0,15933,15933,315,379.35714285714283
camel,org.apache.camel.converter,386,11514,4408,15922,110,41.248704663212436
camel,org.apache.camel.component.netty4.http,206,14284,1604,15888,244,77.12621359223301
camel,org.apache.camel.component.activemq,117,10709,4994,15703,70,134.2136752136752
camel,org.apache.camel.impl.converter,346,9489,6026,15515,63,44.84104046242775
camel,org.apache.camel.component.infinispan,167,10614,4632,15246,68,91.2934131736527
camel,org.apache.camel.component.http4,314,9694,5135,14829,170,47.22611464968153
camel,org.apache.camel.model.rest,290,10349,4307,14656,121,50.53793103448276
camel,org.apache.camel.spring.processor,314,12678,1938,14616,323,46.547770700636946
camel,org.apache.camel.component.seda,440,10591,4001,14592,144,33.163636363636364
camel,org.apache.camel.dataformat.bindy.csv,171,10780,3690,14470,63,84.61988304093568
camel,org.apache.camel.component.jpa,300,9793,4312,14105,60,47.016666666666666
camel,org.apache.camel.component.rest.openapi,126,10537,3201,13738,42,109.03174603174604
camel,org.apache.camel.spring.boot,227,8149,5528,13677,59,60.25110132158591
camel,org.apache.camel.language,282,10798,2790,13588,143,48.184397163120565
camel,org.apache.camel.component.google.mail,128,10128,3432,13560,73,105.9375
camel,org.apache.camel.component.google.calendar,125,10580,2938,13518,79,108.144
camel,org.apache.camel.component.file.strategy,238,8764,4606,13370,86,56.1764705882353
camel,org.apache.camel.impl.lw,148,6995,6374,13369,10,90.33108108108108
camel,org.apache.camel.component.rest,335,9299,3818,13117,112,39.15522388059701
camel,org.apache.camel.component.jms.issues,206,10015,3054,13069,85,63.44174757281554
camel,org.apache.camel.component.mock,353,9741,3240,12981,52,36.773371104815865
camel,org.apache.camel.test.junit5,106,8726,4097,12823,38,120.97169811320755
camel,org.apache.camel.model.cloud,91,9109,3641,12750,120,140.1098901098901
camel,org.apache.camel.component.quickfixj,149,8217,4338,12555,25,84.26174496644295
camel,org.apache.camel.component.salesforce.internal.client,138,8704,3757,12461,28,90.29710144927536
camel,org.apache.camel.impl.console,194,10365,2001,12366,60,63.74226804123711
camel,org.apache.camel.component.kubernetes.producer,89,9172,3130,12302,34,138.22471910112358
camel,org.apache.camel.converter.jaxp,246,8998,3300,12298,59,49.99186991869919
camel,org.apache.camel.component.hazelcast,176,9167,3103,12270,53,69.7159090909091
camel,org.apache.camel.test.junit4,194,6834,5375,12209,34,62.93298969072165
camel,org.apache.camel.component.aws2.sqs,175,9592,2472,12064,77,68.93714285714286
camel,org.apache.camel.xml.out,114,8419,3636,12055,3,105.74561403508773
camel,org.apache.camel.component.servicenow,106,8784,3257,12041,77,113.59433962264151
camel,org.apache.camel.blueprint,231,6102,5894,11996,36,51.93073593073593
camel,org.apache.camel.util.json,31,7631,4175,11806,18,380.83870967741933
camel,org.apache.camel.yaml.out,109,8494,3292,11786,6,108.12844036697248
camel,org.apache.camel.xml.io,35,8680,3090,11770,7,336.2857142857143
camel,org.apache.camel.model.language,288,7953,3792,11745,107,40.78125
camel,org.apache.camel.component.leveldb,77,9396,2243,11639,71,151.15584415584416
camel,org.apache.camel.component.quartz,261,7717,3874,11591,70,44.40996168582375
camel,org.apache.camel.dsl.jbang.core.commands.action,156,9341,2030,11371,33,72.89102564102564
camel,org.apache.camel.component.platform.http.vertx,117,9495,1782,11277,42,96.38461538461539
camel,org.apache.camel.dsl.jbang.core.commands.process,233,9045,2227,11272,44,48.377682403433475
camel,org.apache.camel.component.aws.swf,98,6584,4671,11255,56,114.84693877551021
camel,org.apache.camel.component.xslt,286,8178,3075,11253,166,39.34615384615385
camel,org.apache.camel.component.aws2.athena,73,7523,3451,10974,45,150.32876712328766
camel,org.apache.camel.component.telegram.model,38,10474,477,10951,84,288.1842105263158
camel,org.apache.camel.component.aws.ddb,94,6768,4111,10879,68,115.73404255319149
camel,test.java.org.apache.camel.itest.karaf,35,0,10855,10855,307,310.14285714285717
camel,org.apache.camel.component.aws.sdb,81,7341,3498,10839,69,133.8148148148148
camel,org.apache.camel.component.aws.iam,74,7432,3405,10837,28,146.44594594594594
camel,org.apache.camel.builder.xml,277,8089,2746,10835,70,39.11552346570397
camel,org.apache.camel.component.as2.api,93,7715,3089,10804,31,116.17204301075269
camel,org.apache.camel.component.mongodb3,48,7954,2847,10801,55,225.02083333333334
camel,org.apache.camel.converter.crypto,115,7720,2997,10717,37,93.19130434782609
camel,org.apache.camel.component.azure.storage.blob,70,7848,2847,10695,43,152.78571428571428
camel,org.apache.camel.component.salesforce.internal.processor,111,7159,3463,10622,15,95.69369369369369
camel,org.apache.camel.component.salesforce.dto.generated,33,7086,3528,10614,19,321.6363636363636
camel,org.apache.camel.component.elasticsearch,181,6066,4516,10582,39,58.46408839779006
camel,org.apache.camel.processor.aggregate,333,7357,3187,10544,88,31.663663663663662
camel,org.apache.camel.dsl.jbang.core.commands.kubernetes,116,7646,2709,10355,24,89.26724137931035
camel,org.apache.camel.component.disruptor,143,8272,2027,10299,64,72.02097902097903
camel,org.apache.camel.converter.jaxb,221,6977,3310,10287,47,46.547511312217196
camel,org.apache.camel.processor.onexception,136,8110,2076,10186,137,74.8970588235294
camel,org.apache.camel.component.aws.lambda,111,6601,3445,10046,31,90.50450450450451
camel,org.apache.camel.api.management.mbean,440,8224,1812,10036,214,22.80909090909091
camel,org.apache.camel.component.jms.springboot,76,5012,5012,10024,6,131.89473684210526
camel,org.apache.camel.component.aws.ddbstream,103,6218,3736,9954,48,96.64077669902913
camel,org.apache.camel.component.smb,61,8671,1269,9940,82,162.95081967213116
camel,org.apache.camel.component.redis,85,7369,2561,9930,67,116.82352941176471
camel,org.apache.camel.component.aws2.s3,240,7598,2286,9884,38,41.18333333333333
camel,org.apache.camel.component.google.sheets,96,7237,2589,9826,45,102.35416666666667
camel,org.apache.camel.component.mina2,111,8249,1517,9766,124,87.98198198198199
camel,org.apache.camel.component.debezium.springboot,11,4883,4883,9766,10,887.8181818181819
camel,generated.java.org.apache.camel.builder.endpoint,1,0,9718,9718,1,9718.0
camel,org.apache.camel.core.xml,357,6686,2999,9685,37,27.128851540616246
camel,org.apache.camel.component.xmpp,245,6451,3186,9637,44,39.33469387755102
camel,org.apache.camel.component.pqc,30,9401,193,9594,80,319.8
camel,org.apache.camel.http.common,223,7245,2321,9566,38,42.89686098654708
camel,org.apache.camel.component.exec,109,6387,3143,9530,24,87.43119266055047
camel,org.apache.camel.component.jackson,148,6875,2629,9504,54,64.21621621621621
camel,org.apache.camel.component.milo.client,83,6062,3436,9498,16,114.43373493975903
camel,org.apache.camel.component.twilio.internal,18,7457,2006,9463,60,525.7222222222222
camel,org.apache.camel.component.aws.ec2,112,6228,3181,9409,30,84.00892857142857
camel,org.apache.camel.swagger,160,5633,3621,9254,39,57.8375
camel,org.apache.camel.component.spring.ws,169,6672,2564,9236,32,54.650887573964496
camel,org.apache.camel.component.stream,182,6171,3035,9206,36,50.582417582417584
camel,org.apache.camel.component.microprofile.metrics,45,5923,3178,9101,62,202.24444444444444
camel,org.apache.camel.karaf.commands,117,4781,4304,9085,59,77.64957264957265
camel,org.apache.camel.test.blueprint,182,6679,2385,9064,90,49.8021978021978
camel,test.java.org.apache.camel.cdi.test,8,0,8999,8999,85,1124.875
camel,org.apache.camel.coap,120,6209,2774,8983,30,74.85833333333333
camel,org.apache.camel.component.web3j,79,7283,1687,8970,42,113.54430379746836
camel,org.apache.camel.component.xmlsecurity.processor,60,5642,3275,8917,7,148.61666666666667
camel,org.apache.camel.component.olingo2,150,6381,2511,8892,24,59.28
camel,org.apache.camel.component.aws.kinesis,101,5727,3136,8863,40,87.75247524752476
camel,org.apache.camel.component.irc,181,6053,2728,8781,30,48.51381215469613
camel,org.apache.camel.zipkin,96,5353,3409,8762,41,91.27083333333333
camel,org.apache.camel.component.grpc,112,6934,1768,8702,36,77.69642857142857
camel,org.apache.camel.component.aws2.lambda,159,6141,2420,8561,41,53.84276729559748
camel,org.apache.camel.component.xj,56,6130,2363,8493,33,151.66071428571428
camel,org.apache.camel.component.salesforce.springboot,70,4248,4196,8444,7,120.62857142857143
camel,org.apache.camel.component.jdbc,210,6291,2151,8442,50,40.2
camel,org.apache.camel.component.ahc,157,5433,2996,8429,45,53.68789808917197
camel,org.apache.camel.component.kafka.integration,123,7051,1334,8385,53,68.17073170731707
camel,org.apache.camel.component.aws2.ec2,110,5778,2574,8352,39,75.92727272727272
camel,org.apache.camel.component.twitter,134,5367,2903,8270,61,61.71641791044776
camel,org.apache.camel.component.jmx,140,6132,2138,8270,39,59.07142857142857
camel,org.apache.camel.component.olingo4,131,6350,1910,8260,21,63.05343511450382
camel,org.apache.camel.impl.cloud,118,6172,2086,8258,135,69.98305084745763
camel,org.apache.camel.component.salesforce.api.dto.composite,34,5735,2518,8253,28,242.73529411764707
camel,org.apache.camel.component.ssh,118,6087,2166,8253,34,69.94067796610169
camel,org.apache.camel.test,138,4922,3319,8241,40,59.71739130434783
camel,org.apache.camel.main.download,173,5907,2323,8230,56,47.57225433526011
camel,org.apache.camel.component.mybatis,133,6144,2068,8212,48,61.744360902255636
camel,org.apache.camel.component.as2.api.entity,66,6194,2006,8200,32,124.24242424242425
camel,org.apache.camel.component.jt400,143,5992,2199,8191,40,57.27972027972028
camel,org.apache.camel.test.spring.junit5,53,5269,2909,8178,49,154.30188679245282
camel,org.apache.camel.component.zendesk,88,5936,2235,8171,14,92.85227272727273
camel,org.apache.camel.dsl.jbang.core.commands.k,42,5283,2886,8169,43,194.5
camel,org.apache.camel.component.servlet,214,5769,2329,8098,40,37.8411214953271
camel,org.apache.camel.component.dynamicrouter,16,5008,3077,8085,32,505.3125
camel,org.apache.camel.generator.openapi,67,5871,2203,8074,36,120.50746268656717
camel,org.apache.camel.component.etcd,80,4722,3320,8042,41,100.525
camel,org.apache.camel.component.sjms.jms,87,4908,3114,8022,27,92.20689655172414
camel,org.apache.camel.component.consul,124,5544,2447,7991,40,64.44354838709677
camel,org.apache.camel.component.telegram,112,6020,1905,7925,41,70.75892857142857
camel,org.apache.camel.component.dataset,217,5453,2459,7912,93,36.46082949308756
camel,org.apache.camel.component.hbase,118,4588,3268,7856,28,66.57627118644068
camel,org.apache.camel.component.jclouds,130,4569,3284,7853,25,60.40769230769231
camel,org.apache.camel.component.aws.kms,70,5120,2672,7792,40,111.31428571428572
camel,org.apache.camel.component.aws2.kinesis,158,5705,2079,7784,48,49.265822784810126
camel,org.apache.camel.component.azure.storage.datalake,35,5612,2161,7773,31,222.0857142857143
camel,test.java.org.apache.camel.component.aws.s3,2,0,7764,7764,62,3882.0
camel,org.apache.camel.dsl.jbang.core.commands.edit,6,4065,3696,7761,3,1293.5
camel,org.apache.camel.spring.interceptor,138,6147,1600,7747,83,56.13768115942029
camel,org.apache.camel.component.aws.xray,49,5434,2286,7720,48,157.55102040816325
camel,org.apache.camel.component.netty.springboot,47,3196,4470,7666,6,163.10638297872342
camel,org.apache.camel.component.azure.blob,66,4493,3171,7664,22,116.12121212121212
camel,org.apache.camel.reifier.dataformat,129,5025,2586,7611,134,59.0
camel,org.apache.camel.test.cdi,22,4371,3239,7610,61,345.90909090909093
camel,org.apache.camel.component.cxf.transport,151,5084,2521,7605,52,50.36423841059602
camel,org.apache.camel.component.kamelet,88,6976,533,7509,79,85.32954545454545
camel,org.apache.camel.component.vertx.websocket,64,6444,1044,7488,61,117.0
camel,org.apache.camel.component.aws.sns,123,4645,2833,7478,30,60.796747967479675
camel,org.apache.camel.component.milo.server,75,4728,2710,7438,11,99.17333333333333
camel,org.apache.camel.component.mllp.internal,47,5663,1711,7374,12,156.89361702127658
camel,org.apache.camel.component.pulsar,127,5828,1538,7366,32,58.0
camel,org.apache.camel.component.facebook,98,4560,2746,7306,19,74.55102040816327
camel,org.apache.camel.component.xmlsecurity.api,44,5467,1671,7138,24,162.22727272727272
camel,org.apache.camel.dataformat.protobuf.generated,14,5506,1631,7137,2,509.7857142857143
camel,org.apache.camel.component.xmlsecurity.springboot,39,3565,3565,7130,6,182.82051282051282
camel,org.apache.camel.dataformat.beanio,46,5613,1509,7122,25,154.82608695652175
camel,org.apache.camel.component.docker,101,4906,2213,7119,18,70.48514851485149
camel,org.apache.camel.component.vertx.http,74,6263,836,7099,86,95.93243243243244
camel,org.apache.camel.jsonpath,123,5932,1161,7093,61,57.666666666666664
camel,org.apache.camel.component.aws.ses,93,4573,2508,7081,28,76.13978494623656
camel,org.apache.camel.component.couchbase,90,4812,2265,7077,24,78.63333333333334
camel,org.apache.camel.component.printer,104,4632,2417,7049,13,67.77884615384616
camel,org.apache.camel.component.google.storage,61,4888,2145,7033,30,115.29508196721312
camel,org.apache.camel.spring.config,163,5507,1522,7029,90,43.122699386503065
camel,org.apache.camel.routepolicy.quartz,87,4335,2669,7004,24,80.50574712643679
camel,org.apache.camel.core.osgi,180,3155,3807,6962,70,38.67777777777778
camel,org.apache.camel.component.flatpack,143,5269,1678,6947,40,48.58041958041958
camel,org.apache.camel.component.avro,104,4784,2161,6945,79,66.77884615384616
camel,generated.java.org.apache.camel.model.placeholder,1,0,6920,6920,146,6920.0
camel,org.apache.camel.model.placeholder,1,6920,0,6920,146,6920.0
camel,org.apache.camel.component.milo,50,4648,2249,6897,16,137.94
camel,org.apache.camel.component.micrometer,90,5230,1604,6834,32,75.93333333333334
camel,org.apache.camel.testng,70,4457,2341,6798,29,97.11428571428571
camel,org.apache.camel.opentracing,65,4408,2337,6745,36,103.76923076923077
camel,org.apache.camel.component.aws2.ecs,108,4873,1853,6726,57,62.27777777777778
camel,org.apache.camel.component.quartz2,113,5863,856,6719,99,59.46017699115044
camel,org.apache.camel.spring.spi,239,4199,2490,6689,27,27.98744769874477
camel,test.java.org.apache.camel.component.netty.http,5,0,6687,6687,93,1337.4
camel,org.apache.camel.component.xquery,202,4555,2114,6669,31,33.01485148514851
camel,org.apache.camel.dataformat.univocity.springboot,34,3328,3328,6656,18,195.76470588235293
camel,org.apache.camel.util.jsse,49,5750,888,6638,22,135.46938775510205
camel,org.apache.camel.component.amqp.springboot,54,3311,3311,6622,6,122.62962962962963
camel,org.apache.camel.component.log,226,5107,1511,6618,48,29.283185840707965
camel,org.apache.camel.component.hawtdb,94,4790,1808,6598,36,70.19148936170212
camel,org.apache.camel.test.patterns,82,6263,325,6588,101,80.34146341463415
camel,org.apache.camel.component.soroushbot.component,54,4233,2340,6573,44,121.72222222222223
camel,org.apache.camel.example,130,4361,2211,6572,63,50.55384615384615
camel,org.apache.camel.impl.health,121,4479,2059,6538,53,54.03305785123967
camel,org.apache.camel.component.aws.cw,87,4354,2181,6535,35,75.11494252873563
camel,org.apache.camel.component.jms.tx,128,4864,1639,6503,40,50.8046875
camel,org.apache.camel.component.keycloak,9,6406,84,6490,16,721.1111111111111
camel,org.apache.camel.component.docker.producer,34,4133,2357,6490,2,190.88235294117646
camel,org.apache.camel.component.cm.test,27,3770,2713,6483,14,240.11111111111111
camel,sample.camel,70,3559,2919,6478,97,92.54285714285714
camel,org.apache.camel.component.cache,88,4115,2335,6450,30,73.29545454545455
camel,org.apache.camel.component.cmis,92,3464,2981,6445,20,70.05434782608695
camel,org.apache.camel.component.aws.mq,71,4100,2328,6428,28,90.53521126760563
camel,org.apache.camel.component.azure.eventhubs,53,4948,1467,6415,35,121.0377358490566
camel,org.apache.camel.web.util,59,3232,3182,6414,31,108.71186440677967
camel,org.apache.camel.converter.stream,171,4409,2005,6414,46,37.50877192982456
camel,org.apache.camel.component.paho,122,4535,1865,6400,24,52.459016393442624
camel,test.java.org.apache.camel.component.restlet,5,0,6399,6399,89,1279.8
camel,org.apache.camel.component.vertx.kafka,35,4919,1460,6379,52,182.25714285714287
camel,org.apache.camel.component.jetty.rest,93,5350,1028,6378,88,68.58064516129032
camel,org.apache.camel.component.cometd,153,4830,1535,6365,29,41.60130718954248
camel,org.apache.camel.builder.script,102,3935,2408,6343,43,62.18627450980392
camel,org.apache.camel.component.docling,9,6211,116,6327,23,703.0
camel,org.apache.camel.component.google.pubsub,112,4224,2099,6323,21,56.455357142857146
camel,org.apache.camel.component.sjms.consumer,91,4503,1799,6302,32,69.25274725274726
camel,org.apache.camel.component.zookeeper,143,4701,1592,6293,31,44.00699300699301
camel,org.apache.camel.component.google.sheets.stream,69,4211,2076,6287,21,91.1159420289855
camel,org.apache.camel.component.salesforce.internal.streaming,86,4153,2130,6283,9,73.05813953488372
camel,org.apache.camel.component.aws2.ddb,106,4957,1311,6268,59,59.132075471698116
camel,org.apache.camel.component.netty.http.springboot,44,2863,3378,6241,9,141.8409090909091
camel,org.apache.camel.component.thymeleaf,16,5601,625,6226,45,389.125
camel,org.apache.camel.component.file.remote.sftp,87,4508,1700,6208,43,71.35632183908046
camel,org.apache.camel.support.builder,114,4960,1238,6198,11,54.36842105263158
camel,org.apache.camel.component.azure.storage.queue,60,4675,1493,6168,35,102.8
camel,org.apache.camel.processor.jpa,121,4602,1554,6156,34,50.87603305785124
camel,org.apache.camel.component.nats,131,4536,1615,6151,33,46.954198473282446
camel,org.apache.camel.parser,44,5482,626,6108,56,138.8181818181818
camel,org.apache.camel.component.microprofile.faulttolerance,62,4654,1440,6094,42,98.29032258064517
camel,org.apache.camel.component.thrift,69,4721,1365,6086,24,88.20289855072464
camel,org.apache.camel.dataformat.xmlsecurity,90,4334,1721,6055,9,67.27777777777777
camel,org.apache.camel.language.simple.ast,135,5076,974,6050,65,44.81481481481482
camel,test.java.org.apache.camel.processor,36,0,6017,6017,74,167.13888888888889
camel,org.apache.camel.component.snmp,128,4493,1498,5991,29,46.8046875
camel,org.apache.camel.component.reactive.streams,114,4976,1002,5978,35,52.43859649122807
camel,org.apache.camel.component.mllp.impl,11,4422,1549,5971,19,542.8181818181819
camel,org.apache.camel.component.elsql,89,3664,2277,5941,22,66.75280898876404
camel,org.apache.camel.component.beanstalk,78,3770,2156,5926,23,75.97435897435898
camel,org.apache.camel.component.hystrix.processor,98,3585,2295,5880,32,60.0
camel,org.apache.camel.component.ehcache,89,4263,1574,5837,20,65.58426966292134
camel,org.apache.camel.component.sjms.producer,90,3847,1989,5836,21,64.84444444444445
camel,org.apache.camel.spring.boot.actuate.endpoint,42,3540,2263,5803,28,138.16666666666666
camel,org.apache.camel.component.atom,150,3904,1811,5715,33,38.1
camel,org.apache.camel.component.kubernetes.consumer,44,3703,2011,5714,14,129.86363636363637
camel,org.apache.camel.component.jbpm,60,3091,2622,5713,13,95.21666666666667
camel,org.apache.camel.component.netty4.springboot,58,3490,2216,5706,8,98.37931034482759
camel,org.apache.camel.component.validator,170,4160,1546,5706,52,33.56470588235294
camel,org.apache.camel.component.cassandra,109,3984,1710,5694,20,52.23853211009175
camel,org.apache.camel.component.platform.http.main,56,3925,1727,5652,10,100.92857142857143
camel,org.apache.camel.component.knative.http,26,5262,386,5648,18,217.23076923076923
camel,test.java.org.apache.camel.test.patterns,9,2,5600,5602,94,622.4444444444445
camel,org.apache.camel.component.rest.swagger,79,3533,2030,5563,17,70.41772151898734
camel,org.apache.camel.component.salesforce.api.dto,61,4437,1123,5560,42,91.14754098360656
camel,org.apache.camel.component.salesforce.api.dto.bulk,17,4045,1514,5559,18,327.0
camel,org.apache.camel.component.aws2.ddbstream,101,4148,1343,5491,47,54.366336633663366
camel,org.apache.camel.component.weather,107,3843,1606,5449,32,50.925233644859816
camel,org.apache.camel.component.aws2.s3.integration,82,4855,594,5449,54,66.45121951219512
camel,org.apache.camel.component.sjms.batch,85,3277,2143,5420,12,63.76470588235294
camel,org.apache.camel.component.corda,63,3495,1923,5418,56,86.0
camel,org.apache.camel.processor.aggregate.jdbc,103,3613,1802,5415,47,52.57281553398058
camel,org.apache.camel.component.atmosphere.websocket,132,3678,1724,5402,27,40.92424242424242
camel,org.apache.camel.cdi.xml,58,2700,2700,5400,21,93.10344827586206
camel,org.apache.camel.component.cm,77,3293,2107,5400,21,70.12987012987013
camel,org.apache.camel.component.minio,60,4274,1109,5383,16,89.71666666666667
camel,org.apache.camel.component.netty4.http.springboot,54,3107,2236,5343,13,98.94444444444444
camel,org.apache.camel.component.aws2.iam,104,4103,1213,5316,37,51.11538461538461
camel,org.apache.camel.component.yammer,86,3212,2085,5297,28,61.593023255813954
camel,org.apache.camel.maven.dsl.yaml,71,4003,1292,5295,3,74.5774647887324
camel,org.apache.camel.language.csimple.joor,51,4591,692,5283,13,103.58823529411765
camel,org.apache.camel.component.huaweicloud.obs,29,4864,414,5278,41,182.0
camel,test.java.org.apache.camel.component.netty,5,0,5241,5241,66,1048.2
camel,org.apache.camel.microprofile.health,40,3906,1323,5229,27,130.725
camel,org.apache.camel.component.jhc,39,2659,2550,5209,16,133.56410256410257
camel,org.apache.camel.osgi,101,3483,1699,5182,46,51.306930693069305
camel,org.apache.camel.component.file.remote.integration,57,2883,2253,5136,261,90.10526315789474
camel,org.apache.camel.component.elasticsearch5,22,3920,1213,5133,25,233.3181818181818
camel,test.java.org.apache.camel.dataformat.protobuf.generated,2,0,5107,5107,2,2553.5
camel,org.apache.camel.component.jcr,160,3834,1270,5104,29,31.9
camel,org.apache.camel.component.ibatis,87,3177,1924,5101,25,58.632183908045974
camel,org.apache.camel.component.aws.eks,53,3198,1898,5096,28,96.15094339622641
camel,org.apache.camel.component.docker.headers,39,3935,1142,5077,36,130.17948717948718
camel,org.apache.camel.component.timer,211,3523,1538,5061,48,23.98578199052133
camel,org.apache.camel.util.component,60,4085,967,5052,21,84.2
camel,org.apache.camel.component.aws.ecs,54,3153,1874,5027,28,93.0925925925926
camel,org.apache.camel.component.aws2.sns,113,3923,1098,5021,47,44.43362831858407
camel,org.apache.camel.component.ignite,47,3731,1287,5018,18,106.76595744680851
camel,org.apache.camel.component.box.internal,46,3145,1870,5015,26,109.02173913043478
camel,org.apache.camel.component.hdfs2,73,4560,449,5009,35,68.61643835616438
camel,org.apache.camel.component.facebook.data,46,2636,2369,5005,7,108.80434782608695
camel,org.apache.camel.component.jcache,83,4093,909,5002,27,60.265060240963855
camel,org.apache.camel.opentelemetry,54,4262,731,4993,31,92.46296296296296
camel,org.apache.camel.component.openshift,42,3251,1737,4988,34,118.76190476190476
camel,org.apache.camel.component.undertow.rest,66,4141,846,4987,43,75.56060606060606
camel,org.apache.camel.maven.connector,45,2972,2013,4985,7,110.77777777777777
camel,org.apache.camel.tooling.model,76,4010,970,4980,29,65.52631578947368
camel,org.apache.camel.component.sjms.tx,56,3201,1750,4951,25,88.41071428571429
camel,org.apache.camel.component.sip,73,2764,2183,4947,10,67.76712328767124
camel,org.apache.camel.component.google.calendar.stream,85,3472,1461,4933,21,58.03529411764706
camel,org.apache.camel.component.cxf.converter,130,3535,1396,4931,26,37.93076923076923
camel,org.apache.camel.component.dozer,83,2886,2035,4921,22,59.28915662650602
camel,org.apache.camel.component.cxf.util,109,3256,1658,4914,28,45.08256880733945
camel,test.java.org.apache.camel.test.spring,8,0,4894,4894,106,611.75
camel,org.apache.camel.component.aws2.ses,106,3741,1151,4892,38,46.15094339622642
camel,org.apache.camel.component.optaplanner,91,3457,1432,4889,24,53.72527472527472
camel,org.apache.camel.maven.packaging.model,58,2630,2233,4863,16,83.84482758620689
camel,org.apache.camel.util.concurrent,114,3460,1401,4861,45,42.64035087719298
camel,org.apache.camel.processor.loadbalancer,128,3007,1846,4853,50,37.9140625
camel,org.apache.camel.dsl.jbang.core.commands.kubernetes.traits.model,10,4051,758,4809,30,480.9
camel,org.apache.camel.component.stax,83,3348,1457,4805,18,57.89156626506024
camel,org.apache.camel.component.aws2.mq,107,3614,1174,4788,37,44.74766355140187
camel,org.apache.camel.component.jetty9.springboot,50,2385,2385,4770,8,95.4
camel,org.apache.camel.component.azure.servicebus,54,4004,719,4723,23,87.46296296296296
camel,org.apache.camel.component.hystrix,21,2890,1814,4704,26,224.0
camel,org.apache.camel.component.jbi,36,2724,1966,4690,40,130.27777777777777
camel,org.apache.camel.component.pubnub,74,3329,1358,4687,22,63.33783783783784
camel,org.apache.camel.processor.intercept,88,3769,916,4685,105,53.23863636363637
camel,org.apache.camel.component.sparkrest,97,2380,2292,4672,49,48.16494845360825
camel,org.apache.camel.dsl.jbang.core.common,183,3807,858,4665,35,25.491803278688526
camel,org.apache.camel.component.jetty.jettyproducer,94,4056,602,4658,82,49.5531914893617
camel,org.apache.camel.itest.osgi.blueprint,83,3498,1140,4638,30,55.87951807228916
camel,org.apache.camel.component.gora,62,2683,1945,4628,15,74.64516129032258
camel,org.apache.camel.component.git.producer,59,2610,2013,4623,5,78.35593220338983
camel,org.apache.camel.component.springrabbit,62,4143,468,4611,37,74.37096774193549
camel,org.apache.camel.component.connector,40,2298,2298,4596,9,114.9
camel,org.apache.camel.component.splunk,91,3518,1076,4594,21,50.48351648351648
camel,org.apache.camel.component.aws2.sts,65,3536,1056,4592,48,70.64615384615385
camel,org.apache.camel.dataformat.xstream,107,3145,1443,4588,26,42.87850467289719
camel,org.apache.camel.component.directvm,130,2988,1589,4577,45,35.207692307692305
camel,org.apache.camel.component.atomix.client.map,61,2938,1631,4569,21,74.90163934426229
camel,org.apache.camel.dataformat.soap,79,3163,1399,4562,27,57.74683544303797
camel,org.apache.camel.component.cxf.interceptors,57,2543,2016,4559,28,79.98245614035088
camel,test.java.org.apache.camel.component.aws.sqs,3,0,4551,4551,37,1517.0
camel,org.apache.camel.component.spark,71,3294,1226,4520,40,63.66197183098591
camel,org.apache.camel.component.direct,195,3166,1345,4511,41,23.133333333333333
camel,org.apache.camel.component.milo.client.internal,29,2749,1761,4510,1,155.51724137931035
camel,org.apache.camel.component.robotframework,48,3440,1066,4506,12,93.875
camel,org.apache.camel.view,88,2310,2192,4502,11,51.15909090909091
camel,org.apache.camel.component.infinispan.embedded,34,3857,639,4496,61,132.23529411764707
camel,org.apache.camel.component.google.mail.stream,88,2916,1573,4489,25,51.01136363636363
camel,org.apache.camel.component.vm,112,3255,1230,4485,66,40.044642857142854
camel,org.apache.camel.component.infinispan.remote,48,3608,872,4480,66,93.33333333333333
camel,org.apache.camel.component.sql.stored,102,3421,1057,4478,33,43.90196078431372
camel,org.apache.camel.component.amqp,128,3114,1360,4474,18,34.953125
camel,org.apache.camel.component.jms.reply,140,3094,1376,4470,23,31.928571428571427
camel,org.apache.camel.component.crypto,97,3189,1276,4465,13,46.03092783505155
camel,org.apache.camel.component.rss,129,3126,1320,4446,32,34.46511627906977
camel,org.apache.camel.web.groovy,20,3706,737,4443,50,222.15
camel,org.apache.camel.component.resilience4j,75,3653,776,4429,25,59.053333333333335
camel,org.apache.camel.test.junit5.patterns,23,4193,228,4421,60,192.2173913043478
camel,org.apache.camel.itest.jms,108,3190,1218,4408,24,40.81481481481482
camel,org.apache.camel.spring.xml,75,2406,1999,4405,57,58.733333333333334
camel,org.apache.camel.bam,57,2812,1587,4399,36,77.17543859649123
camel,org.apache.camel.component.yammer.model,13,2196,2196,4392,20,337.84615384615387
camel,org.apache.camel.component.salesforce.api.utils,47,2916,1468,4384,41,93.27659574468085
camel,org.apache.camel.component.mqtt,66,2669,1711,4380,17,66.36363636363636
camel,org.apache.camel.component.huaweicloud.dms,19,4057,318,4375,39,230.26315789473685
camel,org.apache.camel.opentracing.decorators,35,3879,490,4369,64,124.82857142857142
camel,org.apache.camel.impl.event,61,2951,1411,4362,96,71.50819672131148
camel,org.apache.camel.runtimecatalog,29,1232,3088,4320,25,148.9655172413793
camel,org.apache.camel.component.file.remote.strategy,49,2597,1722,4319,15,88.14285714285714
camel,org.apache.camel.component.google.drive.internal,30,3484,835,4319,36,143.96666666666667
camel,org.apache.camel.component.aws2.eks,101,3284,1034,4318,38,42.75247524752475
camel,org.apache.camel.component.kafka.springboot,69,2158,2158,4316,6,62.55072463768116
camel,org.apache.camel.parser.helper,78,3103,1196,4299,20,55.11538461538461
camel,org.apache.camel.component.cxf.spring,123,2886,1412,4298,29,34.94308943089431
camel,org.apache.camel.processor.enricher,104,3470,827,4297,60,41.31730769230769
camel,test.java.org.apache.camel.test.blueprint,4,0,4294,4294,87,1073.5
camel,org.apache.camel.component.linkedin,46,3032,1261,4293,15,93.32608695652173
camel,org.apache.camel.component.velocity,136,3234,1039,4273,32,31.419117647058822
camel,org.apache.camel.dataformat.xstream.springboot,51,2126,2126,4252,12,83.37254901960785
camel,org.apache.camel.component.smpp.springboot,44,2121,2121,4242,6,96.4090909090909
camel,org.apache.camel.web.resources,74,1787,2430,4217,20,56.986486486486484
camel,org.apache.camel.component.azure.storage.blob.operations,27,3145,1066,4211,15,155.96296296296296
camel,test.java.org.apache.camel.component.mina,6,0,4210,4210,53,701.6666666666666
camel,org.apache.camel.component.http.helper,74,2672,1537,4209,13,56.87837837837838
camel,org.apache.camel.blueprint.handler,112,2098,2098,4196,1,37.464285714285715
camel,org.apache.camel.component.slack,111,2810,1376,4186,14,37.711711711711715
camel,org.apache.camel.component.as2.api.util,57,3151,1004,4155,15,72.89473684210526
camel,org.apache.camel.component.aws2.msk,96,3142,989,4131,37,43.03125
camel,org.apache.camel.spring.issues,83,3551,574,4125,72,49.69879518072289
camel,test.java.org.apache.camel.support,6,0,4122,4122,9,687.0
camel,org.apache.camel.component.openstack.keystone,48,2749,1370,4119,12,85.8125
camel,org.apache.camel.component.dhis2,32,3415,693,4108,30,128.375
camel,org.apache.camel.component.bean.validator,96,3015,1091,4106,27,42.770833333333336
camel,org.apache.camel.component.huaweicloud.frs,14,3568,538,4106,28,293.2857142857143
camel,org.apache.camel.component.couchdb,93,3051,1050,4101,21,44.096774193548384
camel,generated.java.org.apache.camel.component.google.drive,3,0,4098,4098,41,1366.0
camel,org.apache.camel.component.mail.springboot,53,2041,2041,4082,6,77.01886792452831
camel,test.java.org.apache.camel.component.http,9,0,4075,4075,41,452.77777777777777
camel,org.apache.camel.component.aws.firehose,66,2520,1549,4069,23,61.65151515151515
camel,org.apache.camel.component.crypto.cms,50,2813,1249,4062,12,81.24
camel,org.apache.camel.processor.errorhandler,126,2593,1466,4059,27,32.214285714285715
camel,generated.java.org.apache.camel.builder.component,1,0,4057,4057,1,4057.0
camel,org.apache.camel.telemetry.decorators,3,3963,92,4055,68,1351.6666666666667
camel,org.apache.camel.component.jacksonxml,65,3565,478,4043,37,62.2
camel,org.apache.camel.component.platform.http,108,3221,818,4039,23,37.398148148148145
camel,org.apache.camel.language.joor,52,3349,690,4039,38,77.67307692307692
camel,org.apache.camel.component.aws2.kms,91,3018,1015,4033,31,44.31868131868132
camel,org.apache.camel.component.jira.producer,26,3510,520,4030,27,155.0
camel,test.java.org.apache.camel.impl,25,0,4029,4029,34,161.16
camel,org.apache.camel.processor.resequencer,82,2955,1060,4015,67,48.96341463414634
camel,org.apache.camel.component.jira,87,2851,1151,4002,20,46.0
camel,org.apache.camel.component.zookeeper.policy,37,2480,1507,3987,13,107.75675675675676
camel,org.apache.camel.component.aries,14,3108,875,3983,18,284.5
camel,org.apache.camel.component.jbpm.workitem,27,2545,1437,3982,16,147.4814814814815
camel,org.apache.camel.component.springldap,58,2547,1432,3979,13,68.60344827586206
camel,org.apache.camel.spring.handler,210,2580,1398,3978,9,18.942857142857143
camel,org.apache.camel.commands.jolokia,40,2165,1797,3962,7,99.05
camel,org.apache.camel.component.olingo2.api.impl,40,2951,1006,3957,9,98.925
camel,org.apache.camel.component.azure.queue,57,2362,1569,3931,16,68.96491228070175
camel,org.apache.camel.component.nagios,99,2392,1523,3915,16,39.54545454545455
camel,org.apache.camel.support.processor,102,2865,1042,3907,40,38.30392156862745
camel,org.apache.camel.component.resteasy,39,2108,1781,3889,11,99.71794871794872
camel,org.apache.camel.converter.crypto.springboot,33,1943,1943,3886,12,117.75757575757575
camel,org.apache.camel.component.ganglia,65,2509,1370,3879,14,59.676923076923075
camel,org.apache.camel.component.zendesk.internal,31,3041,828,3869,6,124.80645161290323
camel,org.apache.camel.component.aws2.translate,116,2873,995,3868,44,33.3448275862069
camel,test.java.org.apache.camel.component.solr,4,0,3868,3868,16,967.0
camel,org.apache.camel.dataformat.bindy.fix,51,2560,1306,3866,14,75.80392156862744
camel,org.apache.camel.component.dynamicrouter.control,11,3451,394,3845,19,349.54545454545456
camel,org.apache.camel.language.datasonnet,26,2964,869,3833,13,147.42307692307693
camel,org.apache.camel.component.keycloak.security,8,3731,87,3818,11,477.25
camel,test.java.org.apache.camel.component.activemq,4,0,3816,3816,36,954.0
camel,org.apache.camel.component.spring.integration,106,2173,1642,3815,19,35.990566037735846
camel,test.java.org.apache.camel.component.netty4,3,0,3785,3785,51,1261.6666666666667
camel,org.apache.camel.component.milo.browse,12,3037,742,3779,7,314.9166666666667
camel,org.apache.camel.component.google.bigquery,72,2488,1291,3779,18,52.486111111111114
camel,org.foo.salesforce.upsert.contact,1,3764,0,3764,8,3764.0
camel,generated.java.org.foo.salesforce.upsert.contact,1,0,3764,3764,8,3764.0
camel,test.java.org.apache.camel.component.websocket,4,0,3747,3747,30,936.75
camel,test.java.org.apache.camel.component.aws.iam,2,0,3743,3743,11,1871.5
camel,org.apache.camel.component.hipchat,54,2497,1242,3739,20,69.24074074074075
camel,org.apache.camel.guice.maven,32,1866,1866,3732,3,116.625
camel,org.apache.camel.component.file.azure,32,3529,196,3725,27,116.40625
camel,org.apache.camel.generator.swagger,46,2102,1615,3717,22,80.80434782608695
camel,org.apache.camel.language.tokenizer,74,2528,1184,3712,23,50.16216216216216
camel,org.apache.camel.component.openstack.neutron,47,2484,1220,3704,11,78.80851063829788
camel,org.apache.camel.spring.remoting,83,2388,1303,3691,37,44.46987951807229
camel,org.apache.camel.component.dns,62,2577,1103,3680,35,59.354838709677416
camel,org.apache.camel.catalog.maven,64,2365,1297,3662,29,57.21875
camel,org.apache.camel.component.arangodb,39,3124,533,3657,25,93.76923076923077
camel,org.apache.camel.language.csimple,65,2897,747,3644,16,56.06153846153846
camel,org.apache.camel.component.weka,43,2266,1372,3638,13,84.6046511627907
camel,org.apache.camel.dsl.yaml,77,2260,1372,3632,7,47.16883116883117
camel,org.apache.camel.jms,23,2324,1302,3626,32,157.65217391304347
camel,org.apache.camel.component.file.watch,64,2601,1017,3618,14,56.53125
camel,test.java.org.apache.camel.component.aws.sdb,2,0,3613,3613,32,1806.5
camel,org.apache.camel.converter.aries,5,2424,1173,3597,42,719.4
camel,org.apache.camel.component.langchain4j.agent,11,3247,327,3574,27,324.90909090909093
camel,org.apache.camel.component.mina2.springboot,44,2059,1498,3557,8,80.8409090909091
camel,org.apache.camel.component.jetty9,102,2500,1055,3555,23,34.85294117647059
camel,org.apache.camel.component.metrics,85,2176,1373,3549,37,41.752941176470586
camel,org.apache.camel.component.rmi,76,2077,1467,3544,23,46.63157894736842
camel,org.apache.camel.parser.java,47,2362,1177,3539,114,75.29787234042553
camel,org.apache.camel.component.box2,2,3528,5,3533,16,1766.5
camel,org.apache.camel.cdi.bean,19,2407,1124,3531,47,185.8421052631579
camel,org.apache.camel.component.ironmq,84,2803,708,3511,20,41.79761904761905
camel,org.apache.camel.component.kubernetes.ha.lock,12,2259,1238,3497,10,291.4166666666667
camel,org.apache.camel.converter.dozer,57,1990,1505,3495,14,61.31578947368421
camel,org.apache.camel.component.neo4j,15,2799,691,3490,39,232.66666666666666
camel,org.apache.camel.builder.saxon,83,2700,790,3490,27,42.04819277108434
camel,org.apache.camel.component.stomp,113,2673,813,3486,17,30.849557522123895
camel,org.apache.camel.support.jsse,64,1689,1791,3480,45,54.375
camel,test.java.org.apache.camel.component.jetty.jettyproducer,5,0,3454,3454,47,690.8
camel,test.java.org.apache.camel.component.hdfs,5,0,3453,3453,13,690.6
camel,org.apache.camel.itest.jetty,65,2652,800,3452,25,53.10769230769231
camel,org.apache.camel.component.servlet.rest,43,2940,511,3451,32,80.25581395348837
camel,org.apache.camel.component.geocoder,68,2512,896,3408,20,50.11764705882353
camel,org.apache.camel.component.facebook.config,25,1725,1677,3402,4,136.08
camel,org.apache.camel.tooling.util,59,1719,1683,3402,14,57.66101694915254
camel,org.apache.camel.component.aws.msk,52,2111,1283,3394,16,65.26923076923077
camel,org.apache.camel.component.aws.secretsmanager,119,2810,568,3378,19,28.386554621848738
camel,org.apache.camel.component.consul.cloud,64,2434,944,3378,33,52.78125
camel,org.apache.camel.support.component,119,2247,1109,3356,50,28.201680672268907
camel,org.apache.camel.processor.aggregate.cassandra,49,2400,939,3339,14,68.14285714285714
camel,org.apache.camel.dataformat.bindy.fixed.marshall.simple,25,2269,1069,3338,5,133.52
camel,org.apache.camel.component.google.bigquery.sql,67,2301,1031,3332,18,49.73134328358209
camel,org.apache.camel.component.syslog,67,2570,759,3329,23,49.6865671641791
camel,org.apache.camel.cli.connector,115,2481,843,3324,3,28.904347826086955
camel,org.apache.camel.component.dropbox.integration.producer,28,2253,1067,3320,21,118.57142857142857
camel,org.apache.camel.spring.cloud,30,2034,1283,3317,37,110.56666666666666
camel,org.apache.camel.component.flink,57,2869,437,3306,20,58.0
camel,org.apache.camel.component.zookeepermaster,72,2591,710,3301,23,45.84722222222222
camel,org.apache.camel.reifier.language,72,2162,1138,3300,28,45.833333333333336
camel,main,108,1682,1604,3286,2,30.425925925925927
camel,org.apache.camel.impl.springboot,34,1854,1419,3273,26,96.26470588235294
camel,org.apache.camel.component.tika,62,2129,1144,3273,12,52.79032258064516
camel,org.apache.camel.component.cxf.jaxws,49,2353,919,3272,93,66.77551020408163
camel,org.apache.camel.component.nsq,60,1896,1368,3264,13,54.4
camel,org.apache.camel.component.braintree.internal,26,2541,716,3257,24,125.26923076923077
camel,org.apache.camel.component.box.api,41,1503,1744,3247,11,79.1951219512195
camel,org.apache.camel.component.caffeine.cache,75,2556,681,3237,19,43.16
camel,org.apache.camel.spring.model,12,1867,1366,3233,26,269.4166666666667
camel,org.apache.camel.component.atlasmap,19,2377,852,3229,23,169.94736842105263
camel,org.apache.camel.component.gae.auth,27,1976,1249,3225,23,119.44444444444444
camel,org.apache.camel.processor.idempotent.kafka,64,2275,937,3212,13,50.1875
camel,org.apache.camel.dsl.xml.io,70,2347,856,3203,18,45.75714285714286
camel,org.apache.camel.component.freemarker,115,2504,689,3193,24,27.765217391304347
camel,main.resources.archetype-resources.src.main.java,100,1880,1313,3193,62,31.93
camel,org.apache.camel.component.language,117,2486,695,3181,47,27.188034188034187
camel,org.apache.camel.language.xtokenizer,41,1735,1439,3174,32,77.41463414634147
camel,org.apache.camel.component.activemq.springboot,13,1585,1585,3170,2,243.84615384615384
camel,org.apache.directory.server.core.integ5,16,2706,459,3165,8,197.8125
camel,org.apache.camel.component.aws2.stepfunctions,13,3125,36,3161,18,243.15384615384616
camel,org.apache.camel.language.bean,122,2082,1078,3160,10,25.901639344262296
camel,org.apache.camel.component.tahu,7,3137,14,3151,28,450.14285714285717
camel,org.apache.camel.processor.validation,85,2085,1062,3147,14,37.023529411764706
camel,org.apache.camel.component.kubernetes.processor,5,1708,1438,3146,16,629.2
camel,org.apache.camel.component.aws.sqs.springboot,39,1567,1567,3134,5,80.35897435897436
camel,org.apache.camel.maven.packaging.generics,36,2433,700,3133,9,87.02777777777777
camel,org.apache.camel.component.aws.s3.springboot,50,1560,1560,3120,5,62.4
camel,test.java.org.apache.camel.component.leveldb,2,0,3107,3107,30,1553.5
camel,org.apache.camel.component.aws.translate,50,1805,1301,3106,14,62.12
camel,org.apache.camel.component.google.pubsub.integration,33,2761,344,3105,29,94.0909090909091
camel,org.apache.camel.component.jgroups,87,2472,630,3102,22,35.6551724137931
camel,org.apache.camel.component.atomix.client.multimap,47,1929,1168,3097,10,65.8936170212766
camel,org.apache.camel.dsl.java.joor,60,2456,613,3069,22,51.15
camel,org.apache.camel.component.paho.mqtt5,29,2845,218,3063,22,105.62068965517241
camel,org.apache.camel.component.kubernetes,90,2150,895,3045,10,33.833333333333336
camel,org.apache.camel.component.rabbitmq.reply,34,1515,1515,3030,11,89.11764705882354
camel,org.apache.camel.processor.exceptionpolicy,75,2021,1006,3027,15,40.36
camel,org.apache.camel.test.infra.artemis.services,47,2532,491,3023,22,64.31914893617021
camel,org.apache.camel.test.junit.rule.mllp,25,2435,585,3020,5,120.8
camel,org.apache.camel.itest.springboot.util,56,2188,828,3016,9,53.857142857142854
camel,org.apache.camel.spring.management,73,2497,511,3008,65,41.205479452054796
camel,org.apache.camel.tracing.decorators,40,2105,900,3005,83,75.125
camel,org.apache.camel.language.jq,24,2614,389,3003,29,125.125
camel,org.apache.camel.component.aws2.firehose,80,2217,786,3003,25,37.5375
camel,test.java.org.apache.camel.component.quartz,5,0,3001,3001,40,600.2
camel,org.apache.camel.component.ehcache.springboot,40,2268,717,2985,32,74.625
camel,test.java.org.apache.camel.component.hawtdb,2,0,2982,2982,31,1491.0
camel,org.apache.camel.service.lra,41,2579,390,2969,19,72.41463414634147
camel,test.java.org.apache.camel.web.groovy,2,0,2969,2969,50,1484.5
camel,org.apache.camel.component.webhook,53,2372,596,2968,20,56.0
camel,org.apache.camel.language.groovy,88,2319,644,2963,23,33.67045454545455
camel,org.apache.camel.guice,57,1861,1082,2943,18,51.63157894736842
camel,org.apache.camel.component.jdbc.aggregationrepository,4,2886,42,2928,27,732.0
camel,org.apache.camel.component.salesforce.api,49,2162,766,2928,17,59.755102040816325
camel,org.apache.camel.component.azure.cosmosdb,35,2747,172,2919,18,83.4
camel,org.apache.camel.component.snakeyaml,32,2075,844,2919,17,91.21875
camel,org.apache.camel.component.fhir.springboot,25,1459,1459,2918,6,116.72
camel,org.apache.camel.component.openstack.nova,49,1971,943,2914,10,59.46938775510204
camel,org.apache.camel.component.cxf.mtom,65,2097,813,2910,27,44.76923076923077
camel,org.apache.camel.component.spring.batch,93,2143,766,2909,22,31.27956989247312
camel,org.apache.camel.component.vertx.kafka.configuration,13,2432,472,2904,4,223.3846153846154
camel,org.apache.camel.component.lucene,106,2096,807,2903,14,27.38679245283019
camel,org.apache.camel.component.box2.api,2,2891,10,2901,10,1450.5
camel,test.java.org.apache.camel.component.mongodb,4,0,2894,2894,21,723.5
camel,org.apache.camel.language.xpath,76,1739,1147,2886,15,37.973684210526315
camel,org.apache.camel.component.facebook.springboot,33,1442,1442,2884,6,87.39393939393939
camel,org.apache.camel.processor.idempotent,101,2086,790,2876,15,28.475247524752476
camel,org.apache.camel.itest.jmh,41,2569,306,2875,20,70.1219512195122
camel,test.java.org.apache.camel.component.mllp.impl,1,0,2873,2873,12,2873.0
camel,test.java.org.apache.camel.component.aws.lambda,2,0,2872,2872,14,1436.0
camel,org.apache.camel.component.sql.sspt.parser,2,1436,1436,2872,6,1436.0
camel,org.apache.camel.builder.script.springboot,23,1432,1432,2864,24,124.52173913043478
camel,org.apache.camel.component.resteasy.test,6,2399,462,2861,16,476.8333333333333
camel,org.apache.camel.component.micrometer.routepolicy,36,2383,477,2860,23,79.44444444444444
camel,org.apache.camel.maven.component.vertx.kafka.config,3,1752,1105,2857,12,952.3333333333334
camel,org.apache.camel.dataformat.tarfile,59,2282,574,2856,14,48.40677966101695
camel,org.apache.camel.component.cxf.soap.headers,45,2236,615,2851,13,63.355555555555554
camel,org.apache.camel.component.cxf.common.header,36,1886,955,2841,7,78.91666666666667
camel,org.apache.camel.jmxconnect,5,1586,1252,2838,13,567.6
camel,org.apache.camel.component.jira.consumer,39,2057,779,2836,11,72.71794871794872
camel,org.apache.camel.component.ahc.ws,87,1314,1518,2832,16,32.55172413793103
camel,org.apache.camel.tooling.maven,35,2585,242,2827,14,80.77142857142857
camel,org.apache.camel.component.shiro.security,47,2127,700,2827,13,60.148936170212764
camel,org.apache.camel.component.cxf.invoker,18,1436,1388,2824,9,156.88888888888889
camel,org.apache.camel.component.atomix.ha,18,2115,706,2821,19,156.72222222222223
camel,org.apache.camel.component.nitrite,40,2313,504,2817,18,70.425
camel,test.java.org.apache.camel.management,16,1,2815,2816,27,176.0
camel,org.apache.camel.dsl.jbang.core.commands.kubernetes.traits,38,2438,375,2813,20,74.02631578947368
camel,org.apache.camel.dataformat.csv.springboot,37,1405,1405,2810,6,75.94594594594595
camel,org.apache.camel.component.atomix.client.queue,51,1780,1014,2794,12,54.78431372549019
camel,org.apache.camel.component.dynamicrouter.routing,9,2292,495,2787,15,309.6666666666667
camel,org.apache.camel.dataformat.zipfile,84,2089,681,2770,16,32.976190476190474
camel,test.java.org.apache.camel.component.aws.ec2,2,0,2763,2763,13,1381.5
camel,org.apache.camel.component.grok,15,1825,935,2760,9,184.0
camel,org.apache.camel.jaxb,77,2282,466,2748,25,35.688311688311686
camel,org.apache.camel.dsl.jbang.core.commands.catalog,122,2190,558,2748,14,22.524590163934427
camel,org.apache.camel.dataformat.any23,34,1625,1118,2743,19,80.67647058823529
camel,org.apache.camel.component.wordpress.api.model,7,2647,92,2739,37,391.2857142857143
camel,org.apache.camel.component.huaweicloud.iam,14,2482,248,2730,24,195.0
camel,org.apache.camel.dataformat.bindy.format,35,1541,1183,2724,26,77.82857142857142
camel,org.apache.camel.component.linkedin.api,28,1518,1203,2721,13,97.17857142857143
camel,org.apache.camel.routepolicy.quartz2,37,2430,290,2720,28,73.51351351351352
camel,org.apache.camel.reifier.errorhandler,63,1862,852,2714,19,43.07936507936508
camel,org.apache.camel.component.azure.key.vault,51,2134,579,2713,14,53.19607843137255
camel,org.apache.camel.component.jooq,53,2067,645,2712,17,51.16981132075472
camel,org.apache.camel.osgi.tracker,3,1867,843,2710,3,903.3333333333334
camel,org.apache.camel.dsl.jbang.core.commands.bind,10,2468,241,2709,15,270.9
camel,org.apache.camel.component.spring.ws.addressing,16,1976,720,2696,11,168.5
camel,org.apache.camel.component.etcd3,12,1648,1046,2694,13,224.5
camel,org.apache.camel.component.undertow.ws,23,1856,832,2688,8,116.8695652173913
camel,org.apache.camel.component.aws.swf.springboot,29,1343,1343,2686,5,92.62068965517241
camel,org.apache.camel.component.atomix.client.set,53,1638,1047,2685,12,50.660377358490564
camel,org.apache.camel.catalog.nexus,23,1454,1230,2684,23,116.69565217391305
camel,org.apache.camel.example.reportincident,55,1686,996,2682,23,48.763636363636365
camel,org.apache.camel.component.snakeyaml.custom,5,1360,1320,2680,5,536.0
camel,org.apache.camel.impl.ha,18,2399,275,2674,15,148.55555555555554
camel,test.java.org.apache.camel.processor.interceptor,7,2,2672,2674,24,382.0
camel,org.apache.camel.component.crypto.springboot,40,1334,1334,2668,6,66.7
camel,org.apache.camel.component.pdf,69,2066,600,2666,19,38.63768115942029
camel,org.apache.camel.component.servicenow.releases.helsinki,14,2107,559,2666,23,190.42857142857142
camel,org.apache.camel.component.aws2.eventbridge,103,1844,820,2664,29,25.864077669902912
camel,org.apache.camel.component.fhir.api,17,2180,484,2664,14,156.7058823529412
camel,org.apache.camel.component.langchain4j.tools,18,2319,343,2662,26,147.88888888888889
camel,org.apache.camel.component.wal,9,2604,55,2659,23,295.44444444444446
camel,org.apache.camel.component.servletlistener,22,1619,1030,2649,20,120.4090909090909
camel,org.apache.camel.component.opensearch.integration,5,2250,394,2644,8,528.8
camel,org.apache.camel.component.zookeeper.cloud,46,2184,460,2644,14,57.47826086956522
camel,org.apache.camel.component.ipfs,44,1524,1112,2636,8,59.90909090909091
camel,org.apache.camel.model.errorhandler,28,2345,288,2633,24,94.03571428571429
camel,org.apache.camel.telemetry,9,2536,95,2631,29,292.3333333333333
camel,org.apache.camel.component.milo.server.internal,25,1500,1129,2629,3,105.16
camel,org.apache.camel.component.github.consumer,52,2116,511,2627,23,50.51923076923077
camel,org.apache.camel.component.kafka.consumer.support,46,1641,982,2623,18,57.02173913043478
camel,org.apache.camel.component.pojo,44,1276,1344,2620,17,59.54545454545455
camel,org.apache.camel.component.fhir.internal,22,2028,567,2595,18,117.95454545454545
camel,org.apache.camel.component.es,17,2304,290,2594,12,152.58823529411765
camel,org.apache.camel.component.vertx,83,1958,630,2588,28,31.180722891566266
camel,org.apache.camel.component.salesforce.internal,76,1730,855,2585,7,34.01315789473684
camel,org.apache.camel.component.cxf.cxfbean,75,1553,1032,2585,15,34.46666666666667
camel,org.apache.camel.itest.osgi.aws,16,2279,299,2578,16,161.125
camel,org.apache.camel.xml.jaxb,65,1849,725,2574,5,39.6
camel,org.apache.camel.attachment,32,2144,429,2573,20,80.40625
camel,org.apache.camel.spring.boot.util,19,1578,979,2557,20,134.57894736842104
camel,org.apache.camel.component.openstack.swift,45,1732,822,2554,9,56.75555555555555
camel,org.apache.camel.support.cache,57,2024,519,2543,11,44.6140350877193
camel,org.apache.camel.component.jslt,53,2137,404,2541,19,47.943396226415096
camel,org.apache.camel.component.atomix.client.value,54,1590,944,2534,12,46.925925925925924
camel,org.apache.camel.component.aws2.redshift.data,11,2498,22,2520,15,229.0909090909091
camel,org.apache.camel.health,61,1809,707,2516,23,41.24590163934426
camel,org.apache.camel.catalog.impl,75,1237,1278,2515,9,33.53333333333333
camel,org.apache.camel.dataformat.bindy.format.factories,22,2200,314,2514,31,114.27272727272727
camel,org.apache.camel.dataformat.barcode,46,1877,637,2514,10,54.65217391304348
camel,org.apache.camel.component.crypto.cms.crypt,17,1250,1250,2500,9,147.05882352941177
camel,org.apache.camel.component.mongodb.gridfs,70,1590,910,2500,16,35.714285714285715
camel,org.apache.camel.processor.aggregate.hazelcast,41,2031,469,2500,9,60.97560975609756
camel,org.apache.camel.component.exec.impl,35,1612,881,2493,7,71.22857142857143
camel,org.apache.camel.component.google.calendar.internal,20,2066,426,2492,24,124.6
camel,org.apache.camel.component.box.springboot,38,1245,1245,2490,6,65.52631578947368
camel,org.apache.camel.model.loadbalancer,86,1618,870,2488,39,28.930232558139537
camel,org.apache.camel.component.netty.http.rest,30,2014,473,2487,34,82.9
camel,org.apache.camel.observation,18,2365,118,2483,18,137.94444444444446
camel,org.apache.camel.component.atomix.client.messaging,48,1506,975,2481,11,51.6875
camel,org.apache.camel.component.javaspace,28,1514,962,2476,18,88.42857142857143
camel,org.apache.camel.component.apns,60,1598,878,2476,11,41.266666666666666
camel,org.apache.camel.component.openstack.glance,46,1688,788,2476,8,53.82608695652174
camel,test.java.org.apache.camel.component.infinispan,6,0,2466,2466,19,411.0
camel,org.apache.camel.component.jackson.springboot,50,1225,1225,2450,6,49.0
camel,org.apache.camel.component.gson.springboot,52,1222,1222,2444,6,47.0
camel,org.apache.camel.component.krati,28,1472,967,2439,15,87.10714285714286
camel,org.apache.camel.component.crypto.cms.sig,17,1218,1218,2436,8,143.2941176470588
camel,org.apache.camel.dataformat.thrift.generated,11,1627,809,2436,2,221.45454545454547
camel,org.apache.camel.runtimecatalog.impl,36,1341,1089,2430,27,67.5
camel,org.apache.camel.component.xslt.saxon,53,1985,441,2426,16,45.77358490566038
camel,org.apache.camel.component.disruptor.vm,34,2007,419,2426,23,71.3529411764706
camel,org.apache.camel.component.netty.http.handlers,83,1249,1175,2424,6,29.204819277108435
camel,org.apache.camel.processor.idempotent.jdbc,53,1948,475,2423,10,45.716981132075475
camel,org.apache.camel.component.github,70,1867,555,2422,14,34.6
camel,org.apache.camel.component.reactive.streams.engine,53,1942,471,2413,10,45.528301886792455
camel,test.java.org.apache.camel.component.rabbitmq.integration,2,0,2410,2410,19,1205.0
camel,org.apache.camel.component.http4.helper,46,1214,1188,2402,15,52.21739130434783
camel,org.apache.camel.component.mongodb.integration,27,1642,759,2401,24,88.92592592592592
camel,test.java.org.apache.camel.itest.osgi.blueprint,2,0,2399,2399,30,1199.5
camel,org.apache.camel.component,77,1595,803,2398,18,31.142857142857142
camel,org.apache.camel.component.kubernetes.hpa,63,1626,765,2391,7,37.95238095238095
camel,test.java.org.apache.camel.spring.boot,3,0,2388,2388,25,796.0
camel,org.apache.camel.spring.boot.cloud,29,1233,1154,2387,15,82.3103448275862
camel,org.apache.camel.component.cxf.jaxrs.testbean,34,2060,319,2379,34,69.97058823529412
camel,org.apache.camel.component.kudu,44,2027,342,2369,15,53.84090909090909
camel,test.java.org.apache.camel.component.google.drive,3,0,2367,2367,23,789.0
camel,org.apache.camel.component.rest.springboot,31,1181,1181,2362,11,76.19354838709677
camel,org.apache.camel.component.milo.call,17,2012,350,2362,6,138.94117647058823
camel,$packageName,22,1684,673,2357,12,107.13636363636364
camel,org.apache.camel.component.aws2.cw,82,1565,791,2356,36,28.73170731707317
camel,org.apache.camel.component.reactor.engine,35,1921,435,2356,9,67.31428571428572
camel,org.apache.camel.websocket.jsr356,49,1025,1330,2355,17,48.06122448979592
camel,org.apache.camel.component.undertow.handlers,37,1848,506,2354,11,63.62162162162162
camel,org.apache.camel.component.controlbus,95,1826,521,2347,23,24.705263157894738
camel,org.apache.camel.component.zookeepermaster.group.internal,32,2067,267,2334,17,72.9375
camel,org.apache.camel.component.gae.http,41,1596,732,2328,17,56.78048780487805
camel,org.apache.camel.component.azure.storage.datalake.operations,13,1791,531,2322,16,178.6153846153846
camel,org.apache.camel.processor.resume.kafka,39,1580,741,2321,7,59.51282051282051
camel,org.apache.camel.processor.aggregate.zipfile,49,1843,478,2321,11,47.36734693877551
camel,org.apache.camel.component.openstack.cinder,44,1576,741,2317,9,52.65909090909091
camel,org.apache.camel.component.google.mail.internal,20,1930,384,2314,22,115.7
camel,org.apache.camel.support.task,29,2016,295,2311,16,79.6896551724138
camel,test.java.org.apache.camel.component.aws.ddb,2,0,2308,2308,29,1154.0
camel,org.apache.camel.component.scheduler,80,1753,552,2305,24,28.8125
camel,org.apache.camel.component.netty4.http.rest,34,2140,160,2300,56,67.6470588235294
camel,org.apache.camel.component.rabbitmq.integration,31,1464,836,2300,36,74.19354838709677
camel,org.apache.camel.component.influxdb,71,1797,501,2298,16,32.36619718309859
camel,org.apache.camel.component.etcd3.processor.aggregate,15,1189,1102,2291,2,152.73333333333332
camel,org.apache.camel.component.chronicle.engine,22,1258,1028,2286,11,103.9090909090909
camel,org.apache.camel.component.aws.secretsmanager.integration,54,2032,253,2285,21,42.31481481481482
camel,org.apache.camel.component.sjms2,56,1556,722,2278,11,40.67857142857143
camel,org.apache.camel.component.aws2.transcribe,3,2271,4,2275,14,758.3333333333334
camel,org.apache.camel.component.git,82,1690,583,2273,12,27.71951219512195
camel,test.java.org.apache.camel.component.mllp,4,0,2265,2265,14,566.25
camel,org.apache.camel.component.atmos,60,1345,920,2265,8,37.75
camel,org.apache.camel.component.telegram.service,34,1598,666,2264,7,66.58823529411765
camel,org.apache.camel.oauth,6,2068,196,2264,26,377.3333333333333
camel,org.apache.camel.converter.jaxb.springboot,33,1132,1132,2264,6,68.60606060606061
camel,test.java.org.apache.camel.itest.jmh,2,0,2263,2263,20,1131.5
camel,org.apache.camel.component.kestrel,33,1313,948,2261,10,68.51515151515152
camel,org.apache.camel.component.opensearch,13,2102,154,2256,12,173.53846153846155
camel,org.apache.camel.component.chunk,57,1835,419,2254,17,39.54385964912281
camel,org.apache.camel.component.github.producer,41,1955,293,2248,16,54.829268292682926
camel,org.apache.camel.processor.cache,28,1290,956,2246,7,80.21428571428571
camel,org.apache.camel.component.scp,96,1481,765,2246,14,23.395833333333332
camel,org.apache.camel.dsl.modeline,19,1384,859,2243,15,118.05263157894737
camel,org.apache.camel.bam.model,38,1146,1089,2235,16,58.81578947368421
camel,org.apache.camel.micrometer.observability,7,2184,50,2234,19,319.14285714285717
camel,test.java.org.apache.camel.component.microprofile.metrics,2,0,2234,2234,26,1117.0
camel,org.apache.camel.component.google.sheets.server,8,1931,297,2228,6,278.5
camel,org.apache.camel.component.olingo4.api.impl,33,1728,498,2226,3,67.45454545454545
camel,org.apache.camel.component.pgevent,71,1606,619,2225,10,31.338028169014084
camel,generated.java.org.apache.camel.component.google.calendar,1,0,2223,2223,20,2223.0
camel,org.apache.camel.telemetrydev,6,2200,13,2213,19,368.8333333333333
camel,org.apache.camel.component.spring.ws.bean,28,1509,703,2212,6,79.0
camel,org.apache.camel.component.huaweicloud.dms.models,6,2204,5,2209,14,368.1666666666667
camel,org.apache.camel.component.pqc.lifecycle,4,2202,5,2207,6,551.75
camel,org.apache.camel.component.twitter.timeline,54,1498,709,2207,16,40.870370370370374
camel,org.apache.camel.component.knative,26,2063,142,2205,13,84.8076923076923
camel,org.apache.camel.test.main.junit5,21,2014,191,2205,17,105.0
camel,org.apache.camel.groovy.extend,6,1098,1098,2196,10,366.0
camel,org.apache.camel.component.dropbox,73,1544,650,2194,9,30.054794520547944
camel,org.apache.camel.test.infra.activemq.services,16,1809,382,2191,10,136.9375
camel,org.apache.camel.component.servicenow.springboot,43,1095,1095,2190,4,50.93023255813954
camel,org.apache.camel.component.aries.handler,12,1093,1093,2186,14,182.16666666666666
camel,org.apache.camel.management.event,35,1672,510,2182,36,62.34285714285714
camel,org.apache.camel.rx,32,1435,740,2175,19,67.96875
camel,org.apache.camel.component.ssh.springboot,44,1087,1087,2174,6,49.40909090909091
camel,org.apache.camel.dataformat.bindy.fixed,54,1682,490,2172,5,40.22222222222222
camel,test.java.org.apache.camel.component.box,1,0,2170,2170,12,2170.0
camel,org.apache.camel.dataformat.xmljson,22,1584,586,2170,9,98.63636363636364
camel,org.apache.camel.component.azure.storage.queue.operations,10,1718,450,2168,12,216.8
camel,org.apache.camel.component.huaweicloud.smn,22,1982,182,2164,32,98.36363636363636
camel,test.java.org.apache.camel.component.aws.kms,3,0,2164,2164,16,721.3333333333334
camel,org.apache.camel.component.guava.eventbus,69,1699,462,2161,18,31.318840579710145
camel,org.apache.camel.component.file.remote.springboot,23,1080,1080,2160,9,93.91304347826087
camel,org.apache.camel.component.bean.issues,47,1846,313,2159,63,45.93617021276596
camel,org.apache.camel.component.lumberjack,69,1660,493,2153,17,31.202898550724637
camel,org.apache.camel.example.cafe,23,1234,917,2151,17,93.52173913043478
camel,org.apache.camel.component.ribbon.cloud,35,1269,881,2150,16,61.42857142857143
camel,org.apache.felix.bundleplugin,12,1075,1075,2150,5,179.16666666666666
camel,org.apache.camel.component.routebox,25,1321,828,2149,11,85.96
camel,org.apache.camel.maven.packaging.dsl.component,19,1234,911,2145,11,112.89473684210526
camel,org.apache.camel.dsl.jbang.core.commands.infra,20,1623,520,2143,9,107.15
camel,org.apache.camel.component.netty.handlers,76,1081,1058,2139,3,28.144736842105264
camel,org.apache.camel.component.sjms.support,57,1534,599,2133,12,37.421052631578945
camel,test.java.org.apache.camel.component.ahc,1,0,2133,2133,32,2133.0
camel,org.apache.camel.model.remote,11,1508,621,2129,9,193.54545454545453
camel,org.apache.plc4x.camel,3,1770,356,2126,16,708.6666666666666
camel,org.apache.camel.impl.debugger,61,1716,409,2125,12,34.83606557377049
camel,org.apache.camel.opentelemetry2,5,2122,2,2124,17,424.8
camel,org.apache.camel.component.jacksonxml.springboot,34,1061,1061,2122,6,62.411764705882355
camel,org.apache.camel.component.djl,41,1859,257,2116,35,51.609756097560975
camel,test.java.org.apache.camel.testng,5,0,2116,2116,21,423.2
camel,org.apache.camel.guice.support,3,1058,1058,2116,13,705.3333333333334
camel,org.apache.camel.component.jgroups.raft,49,1729,382,2111,17,43.08163265306123
camel,org.apache.camel.component.es.integration,9,2012,95,2107,8,234.11111111111111
camel,org.apache.camel.model.cloud.springboot,16,915,1191,2106,12,131.625
camel,org.apache.camel.component.aws.sns.springboot,32,1053,1053,2106,5,65.8125
camel,org.apache.camel.component.ibm.cos,1,2106,0,2106,11,2106.0
camel,org.apache.camel.component.http.springboot,47,832,1269,2101,8,44.702127659574465
camel,org.apache.camel.component.twitter.search,51,1457,643,2100,11,41.1764705882353
camel,org.apache.camel.component.wordpress,63,1587,512,2099,12,33.317460317460316
camel,org.apache.camel.component.hl7.springboot,34,1049,1049,2098,14,61.705882352941174
camel,org.apache.camel.component.kubernetes.deployments,66,1493,594,2087,7,31.62121212121212
camel,org.apache.camel.impl.remote,10,1238,843,2081,11,208.1
camel,org.apache.camel.component.docker.springboot,34,1040,1040,2080,6,61.1764705882353
camel,org.apache.camel.itest.greeter,56,1570,507,2077,17,37.089285714285715
camel,org.apache.camel.component.aws.eks.springboot,14,1035,1035,2070,6,147.85714285714286
camel,org.apache.camel.component.dapr,6,2014,49,2063,18,343.8333333333333
camel,org.apache.camel.component.rocketmq,23,1949,112,2061,16,89.6086956521739
camel,org.apache.camel.component.langchain4j.embeddings,20,1784,273,2057,23,102.85
camel,org.apache.camel.component.rabbitmq.springboot,32,1027,1027,2054,3,64.1875
camel,org.apache.camel.spi.annotations,35,1932,120,2052,51,58.628571428571426
camel,net.revelc.code.formatter,6,1024,1024,2048,2,341.3333333333333
camel,org.apache.camel.component.smooks,14,1747,297,2044,12,146.0
camel,org.apache.camel.component.asterisk,59,1505,536,2041,16,34.59322033898305
camel,org.apache.camel.component.jms.requestor,17,1109,925,2034,8,119.6470588235294
camel,org.apache.camel.dataformat.xmljson.springboot,29,1017,1017,2034,6,70.13793103448276
camel,org.apache.camel.component.salesforce.api.dto.analytics.reports,14,1932,102,2034,34,145.28571428571428
camel,org.apache.camel.dataformat.xmlsecurity.springboot,36,1017,1017,2034,6,56.5
camel,org.apache.camel.component.zookeeper.operations,33,1799,234,2033,23,61.60606060606061
camel,org.apache.camel.component.atomix.client,32,1102,929,2031,13,63.46875
camel,test.java.org.apache.camel.component.aries,2,0,2029,2029,9,1014.5
camel,org.apache.camel.component.gae.login,19,1187,841,2028,14,106.73684210526316
camel,org.apache.camel.component.aws2.timestream.write,4,2019,5,2024,8,506.0
camel,org.apache.camel.component.digitalocean.producer,18,1074,945,2019,12,112.16666666666667
camel,org.apache.camel.component.gson,59,1747,271,2018,17,34.20338983050848
camel,org.apache.camel.component.jsonvalidator,60,1433,582,2015,25,33.583333333333336
camel,org.apache.camel.component.gae.task,34,1291,720,2011,12,59.14705882352941
camel,org.apache.camel.component.cxf.blueprint,38,975,1034,2009,9,52.86842105263158
camel,org.apache.camel.maven.htmlxlsx.model,1,2006,0,2006,26,2006.0
camel,org.apache.camel.component.openstack.keystone.producer,16,1341,662,2003,6,125.1875
camel,test.java.org.apache.camel.component.aws.ddbstream,3,0,2000,2000,18,666.6666666666666
camel,org.apache.camel.component.graphql,40,1663,328,1991,8,49.775
camel,org.apache.camel.component.paho.springboot,31,995,995,1990,6,64.19354838709677
camel,org.apache.camel.component.aws.ddb.springboot,30,994,994,1988,5,66.26666666666667
camel,org.apache.camel.component.google.bigquery.unit.sql,16,1806,182,1988,14,124.25
camel,test.java.org.apache.camel.itest.osgi.aws,1,0,1980,1980,16,1980.0
camel,org.apache.camel.component.master,74,1450,524,1974,8,26.675675675675677
camel,org.apache.camel.parser.model,22,1729,245,1974,23,89.72727272727273
camel,org.apache.camel.component.whatsapp.model,5,1967,6,1973,36,394.6
camel,org.apache.camel.util.backoff,22,1521,452,1973,13,89.68181818181819
camel,org.apache.camel.component.pinecone,21,1734,236,1970,23,93.80952380952381
camel,org.apache.camel.component.ganglia.springboot,39,985,985,1970,6,50.51282051282051
camel,org.apache.camel.component.stringtemplate,91,1495,472,1967,14,21.615384615384617
camel,org.apache.camel.component.azure.storage.blob.integration,37,1647,320,1967,18,53.16216216216216
camel,generated.java.org.apache.camel.component.vertx.kafka.configuration,1,0,1960,1960,1,1960.0
camel,org.apache.camel.component.aws2.textract,3,1948,11,1959,13,653.0
camel,org.apache.camel.processor.idempotent.cassandra,35,1347,608,1955,9,55.857142857142854
camel,org.apache.camel.component.dynamicrouter.integration,10,1656,291,1947,8,194.7
camel,org.apache.camel.component.aws.kinesis.springboot,31,973,973,1946,5,62.774193548387096
camel,org.apache.camel.rest.resources,26,1461,485,1946,19,74.84615384615384
camel,org.apache.camel.component.restlet.springboot,39,972,972,1944,6,49.84615384615385
camel,test.java.org.apache.camel.test.junit5.patterns,3,2,1940,1942,31,647.3333333333334
camel,org.apache.camel.component.stub,75,1443,498,1941,23,25.88
camel,test.java.org.apache.camel.component.resteasy.test,2,0,1937,1937,16,968.5
camel,org.apache.camel.component.qdrant,17,1855,81,1936,31,113.88235294117646
camel,test.java.org.apache.camel.component.elasticsearch,8,0,1933,1933,14,241.625
camel,org.apache.camel.test.infra.aws2.services,79,1522,405,1927,40,24.39240506329114
camel,org.apache.camel.itest.http,41,1347,578,1925,9,46.951219512195124
camel,org.apache.camel.component.kubernetes.replication_controllers,62,1205,720,1925,7,31.048387096774192
camel,org.apache.camel.dsl.yaml.common,47,1591,333,1924,7,40.93617021276596
camel,test.java.org.apache.camel.component.jms,13,0,1924,1924,14,148.0
camel,org.apache.camel.component.cache.springboot,33,960,960,1920,6,58.18181818181818
camel,org.apache.camel.itest.osgi,101,1342,576,1918,9,18.99009900990099
camel,org.apache.camel.karaf.commands.internal,34,954,954,1908,4,56.11764705882353
camel,org.apache.camel.component.ldap,93,1294,614,1908,12,20.516129032258064
camel,test.java.org.apache.camel.component.vertx.kafka,1,0,1905,1905,15,1905.0
camel,org.apache.camel.maven.generator.swagger,32,952,952,1904,5,59.5
camel,org.apache.camel.component.microprofile.metrics.route.policy,12,1275,625,1900,14,158.33333333333334
camel,org.apache.camel.component.cdi.internal,24,1404,489,1893,9,78.875
camel,org.apache.camel.component.vertx.kafka.operations,10,1375,516,1891,9,189.1
camel,org.apache.camel.component.twitter.directmessage,50,1315,575,1890,11,37.8
camel,org.apache.camel.component.aws.ses.springboot,29,945,945,1890,5,65.17241379310344
camel,org.apache.camel.component.zeebe.model,6,1811,74,1885,21,314.1666666666667
camel,org.apache.camel.support.service,37,1083,800,1883,5,50.891891891891895
camel,test.java.org.apache.camel.component.aws.kinesis,2,0,1883,1883,16,941.5
camel,org.apache.camel.test.main.junit5.annotation,5,1869,14,1883,25,376.6
camel,org.apache.camel.component.netty4.handlers,29,1221,658,1879,3,64.79310344827586
camel,org.apache.camel.component.aws.cw.springboot,30,938,938,1876,5,62.53333333333333
camel,org.apache.camel.swagger.component,11,1116,760,1876,9,170.54545454545453
camel,test.java.org.apache.camel.zipkin,1,0,1871,1871,24,1871.0
camel,org.apache.camel.component.hashicorp.vault.integration,14,1489,381,1870,2,133.57142857142858
camel,org.apache.camel.spring.boot.health,17,1070,798,1868,13,109.88235294117646
camel,org.apache.camel.bam.processor,47,632,1234,1866,12,39.702127659574465
camel,generated.java.org.apache.camel.component.google.mail,1,0,1866,1866,18,1866.0
camel,org.apache.camel.component.hdfs.integration,28,1306,557,1863,7,66.53571428571429
camel,org.apache.camel.component.xchange,50,1417,446,1863,13,37.26
camel,org.apache.camel.itest.tx,37,1427,430,1857,10,50.189189189189186
camel,test.java.org.apache.camel.swagger,1,0,1857,1857,22,1857.0
camel,org.apache.camel.util.toolbox,39,1554,301,1855,7,47.56410256410256
camel,org.apache.camel.component.etcd3.cloud,8,1006,849,1855,7,231.875
camel,org.apache.camel.component.firebase,18,1055,800,1855,8,103.05555555555556
camel,org.apache.camel.spring.javaconfig,49,1016,838,1854,8,37.83673469387755
camel,org.apache.camel.component.validator.jing,64,1120,734,1854,10,28.96875
camel,org.apache.camel.component.properties.springboot,49,1021,829,1850,8,37.755102040816325
camel,org.apache.camel.component.google.calendar.springboot,35,923,923,1846,6,52.74285714285714
camel,org.apache.camel.component.elytron,24,1194,650,1844,9,76.83333333333333
camel,test.java.org.apache.camel.component.vm,2,0,1843,1843,27,921.5
camel,org.apache.camel.itest.cdi,27,1022,819,1841,17,68.18518518518519
camel,org.apache.camel.model.springboot,14,902,937,1839,4,131.35714285714286
camel,org.apache.camel.dataformat.swift.mx,8,1432,403,1835,10,229.375
camel,org.apache.camel.component.linkedin.springboot,40,917,917,1834,6,45.85
camel,org.apache.camel.component.iec60870.server,41,1435,396,1831,10,44.65853658536585
camel,org.apache.camel.component.aws.ddbstream.springboot,29,915,915,1830,5,63.10344827586207
camel,org.apache.camel.component.olingo2.springboot,37,914,914,1828,6,49.4054054054054
camel,org.apache.camel.component.splunkhec,40,1524,301,1825,11,45.625
camel,org.apache.camel.component.huaweicloud.image,12,1757,66,1823,17,151.91666666666666
camel,org.apache.camel.test.infra.openai.mock,2,1803,18,1821,18,910.5
camel,org.apache.camel.component.cxf.feature,54,1217,602,1819,9,33.68518518518518
camel,org.apache.camel.component.kafka.consumer,21,1248,568,1816,18,86.47619047619048
camel,org.apache.camel.component.johnzon.springboot,43,907,907,1814,6,42.18604651162791
camel,test.java.org.apache.camel.component.cache,1,0,1813,1813,14,1813.0
camel,org.apache.camel.spring.util,44,1235,578,1813,18,41.20454545454545
camel,org.apache.camel.component.micrometer.eventnotifier,33,1464,341,1805,15,54.696969696969695
camel,org.apache.camel.component.everit.jsonschema,6,1369,433,1802,17,300.3333333333333
camel,org.apache.camel.catalog.rest,16,1031,770,1801,10,112.5625
camel,org.apache.camel.component.torchserve,4,1790,11,1801,15,450.25
camel,org.apache.camel.catalog.connector,8,983,815,1798,12,224.75
camel,org.apache.camel.vault,37,1670,122,1792,13,48.432432432432435
camel,test.java.org.apache.camel.component.hystrix.processor,4,0,1791,1791,25,447.75
camel,org.apache.camel.test.karaf,31,737,1054,1791,2,57.774193548387096
camel,org.apache.camel.component.fop,71,1334,453,1787,13,25.169014084507044
camel,org.apache.camel.component.iec60870.client,49,1348,437,1785,10,36.42857142857143
camel,org.apache.camel.component.kubernetes.services,63,1145,640,1785,7,28.333333333333332
camel,org.apache.camel.component.ribbon.processor,9,1076,706,1782,10,198.0
camel,org.apache.camel.component.mllp.springboot,31,891,891,1782,3,57.483870967741936
camel,org.apache.camel.component.kubernetes.config_maps,70,1232,543,1775,7,25.357142857142858
camel,org.apache.camel.dataformat.base64,26,1424,348,1772,16,68.15384615384616
camel,test.java.org.apache.camel.component.linkedin,1,0,1771,1771,9,1771.0
camel,org.apache.camel.component.salesforce.api.dto.approval,16,1341,428,1769,8,110.5625
camel,org.apache.camel.dataformat.bindy.annotation,55,1265,504,1769,11,32.163636363636364
camel,org.apache.camel.component.file.cluster,33,1567,200,1767,14,53.54545454545455
camel,org.apache.camel.component.kubernetes.job,53,1190,576,1766,6,33.320754716981135
camel,org.apache.camel.component.pg.replication.slot,43,1374,390,1764,7,41.02325581395349
camel,test.java.org.apache.camel.dsl.jbang.core.commands.k,1,0,1759,1759,9,1759.0
camel,org.apache.camel.component.kubernetes.pods,63,1134,624,1758,7,27.904761904761905
camel,org.apache.camel.component.kubernetes.properties,26,1528,222,1750,18,67.3076923076923
camel,org.apache.camel.component.jasypt,48,1381,369,1750,15,36.458333333333336
camel,org.apache.camel.component.xmlrpc,28,992,755,1747,11,62.392857142857146
camel,org.apache.camel.component.resteasy.servlet,11,873,873,1746,7,158.72727272727272
camel,org.apache.camel.scr,25,1077,668,1745,7,69.8
camel,org.apache.camel.test.issues,20,1622,119,1741,22,87.05
camel,org.apache.camel.impl.verifier,22,1504,235,1739,13,79.04545454545455
camel,org.apache.camel.model.transformer,49,1179,559,1738,25,35.46938775510204
camel,org.apache.camel.test.infra.ftp.services.embedded,11,1266,470,1736,10,157.8181818181818
camel,org.apache.camel.component.braintree.springboot,33,865,865,1730,6,52.42424242424242
camel,test.java.org.apache.camel.component.aws.ses,2,0,1728,1728,13,864.0
camel,org.apache.camel.component.ldif,50,1309,417,1726,9,34.52
camel,org.apache.camel.component.google.pubsublite,11,1685,37,1722,14,156.54545454545453
camel,org.apache.camel.component.servlet.springboot,44,931,789,1720,12,39.09090909090909
camel,org.apache.camel.component.aws2.bedrock,25,1681,36,1717,13,68.68
camel,org.apache.camel.processor.routingslip,47,1375,339,1714,22,36.46808510638298
camel,test.java.org.apache.camel.cdi.bean,2,0,1714,1714,47,857.0
camel,org.apache.camel.component.mustache,61,1317,394,1711,9,28.049180327868854
camel,test.java.org.apache.camel.component.bean,12,0,1710,1710,22,142.5
camel,org.apache.camel.tracing,42,1324,384,1708,12,40.666666666666664
camel,org.apache.camel.component.jolt,60,1302,405,1707,12,28.45
camel,test.java.org.apache.camel.component.file,14,0,1707,1707,25,121.92857142857143
camel,org.apache.camel.component.aws.ec2.springboot,31,853,853,1706,5,55.03225806451613
camel,org.apache.camel.component.web3j.integration,13,1400,304,1704,9,131.07692307692307
camel,org.apache.camel.dataformat.protobuf,53,1390,314,1704,12,32.15094339622642
camel,org.apache.camel.component.jcache.policy,24,1457,238,1695,7,70.625
camel,org.apache.camel.component.springrabbit.integration,21,1559,134,1693,30,80.61904761904762
camel,org.apache.camel.component.rxjava2.engine,15,1541,152,1693,10,112.86666666666666
camel,org.apache.camel.component.aws2.s3.stream,43,1255,437,1692,5,39.348837209302324
camel,org.apache.camel.component.jsch,30,1470,221,1691,9,56.36666666666667
camel,org.apache.camel.component.microprofile.metrics.message.history,12,1066,624,1690,12,140.83333333333334
camel,org.apache.camel.component.file.remote.manual,16,1040,649,1689,8,105.5625
camel,org.apache.camel.component.aws2.bedrock.agent,11,1657,30,1687,11,153.36363636363637
camel,org.apache.camel.component.iota,43,1013,669,1682,8,39.116279069767444
camel,org.apache.camel.component.google.storage.localstorage,11,1627,55,1682,4,152.9090909090909
camel,org.apache.camel.component.hazelcast.queue,63,1234,442,1676,9,26.603174603174605
camel,org.apache.camel.component.consul.springboot,38,837,837,1674,3,44.05263157894737
camel,org.apache.camel.component.sparkrest.springboot,11,890,780,1670,4,151.8181818181818
camel,org.apache.camel.component.google.functions,24,1246,420,1666,18,69.41666666666667
camel,org.apache.camel.loanbroker.queue.version,51,1073,592,1665,16,32.64705882352941
camel,org.apache.camel.component.kubernetes.nodes,64,1106,556,1662,7,25.96875
camel,test.java.org.apache.camel.opentracing,1,0,1661,1661,20,1661.0
camel,org.apache.camel.component.snakeyaml.springboot,43,830,830,1660,6,38.604651162790695
camel,org.apache.camel.component.xslt.springboot,40,830,830,1660,8,41.5
camel,org.apache.camel.component.caffeine.load,59,1185,472,1657,7,28.084745762711865
camel,org.apache.camel.component.consul.enpoint,5,1428,228,1656,25,331.2
camel,org.apache.camel.component.aws.config,12,1630,23,1653,13,137.75
camel,org.apache.camel.example.reactive.streams,8,839,808,1647,10,205.875
camel,org.apache.camel.component.sjms.springboot,36,823,823,1646,6,45.72222222222222
camel,org.apache.camel.support.dump,6,295,1351,1646,9,274.3333333333333
camel,org.apache.camel.component.avro.springboot,33,821,821,1642,6,49.75757575757576
camel,org.apache.camel.maven.packaging.srcgen,9,1529,111,1640,8,182.22222222222223
camel,org.apache.camel.zipkin.scribe,21,1060,579,1639,17,78.04761904761905
camel,org.apache.camel.dataformat.tagsoup,33,1153,486,1639,11,49.666666666666664
camel,org.apache.camel.builder.xpath,9,892,746,1638,6,182.0
camel,test.java.org.apache.camel.component.google.sheets.server,2,0,1634,1634,6,817.0
camel,test.java.org.apache.camel.dataformat.xstream,1,0,1633,1633,20,1633.0
camel,org.apache.camel.test.testcontainers,18,849,784,1633,10,90.72222222222223
camel,org.apache.camel.component.djl.model,18,1181,451,1632,12,90.66666666666667
camel,org.apache.camel.component.caffeine.lrucache,14,748,883,1631,12,116.5
camel,org.apache.camel.component.aws.firehose.springboot,24,813,813,1626,4,67.75
camel,org.apache.camel.component.infinispan.policy,20,893,732,1625,4,81.25
camel,org.apache.camel.core.xml.util.jsse,21,1355,265,1620,29,77.14285714285714
camel,org.apache.camel.component.aws.s3.client.impl,19,971,646,1617,10,85.10526315789474
camel,org.apache.camel.dataformat.flatpack.springboot,32,806,806,1612,6,50.375
camel,org.apache.camel.component.cron,52,1256,355,1611,13,30.98076923076923
camel,org.apache.camel.component.dhis2.api,10,1329,281,1610,13,161.0
camel,org.apache.camel.component.hazelcast.seda,72,1189,420,1609,8,22.34722222222222
camel,org.apache.camel.component.zookeeper.springboot,33,804,804,1608,6,48.72727272727273
camel,org.apache.camel.component.spring.ws.filter.impl,29,1092,513,1605,5,55.3448275862069
camel,org.apache.camel.component.openstack.neutron.producer,10,1077,526,1603,4,160.3
camel,org.apache.camel.test.infra.core,14,1332,270,1602,13,114.42857142857143
camel,org.apache.camel.component.spring.integration.adapter,55,914,686,1600,6,29.09090909090909
camel,org.apache.camel.component.kubernetes.namespaces,56,1052,547,1599,7,28.553571428571427
camel,org.apache.camel.component.websocket.springboot,42,799,799,1598,6,38.04761904761905
camel,org.apache.camel.component.robotframework.springboot,3,799,799,1598,2,532.6666666666666
camel,org.apache.camel.component.google.drive.springboot,34,798,798,1596,6,46.94117647058823
camel,org.apache.camel.component.activemq6,8,1580,14,1594,15,199.25
camel,org.apache.camel.component.google.mail.springboot,34,795,795,1590,6,46.76470588235294
camel,org.apache.camel.component.aws.cloudtrail,33,1390,198,1588,10,48.121212121212125
camel,org.apache.camel.test.testcontainers.junit5,11,847,741,1588,10,144.36363636363637
camel,org.apache.camel.component.aws2.timestream.query,4,1581,6,1587,8,396.75
camel,org.apache.camel.component.ws,2,1365,218,1583,11,791.5
camel,org.apache.camel.component.aws2.sqs.integration,35,1320,263,1583,19,45.22857142857143
camel,org.apache.camel.component.elasticsearch.rest.client,10,1460,123,1583,9,158.3
camel,org.apache.camel.component.schematron,70,1192,390,1582,9,22.6
camel,test.java.org.apache.camel.component.jetty,14,0,1579,1579,17,112.78571428571429
camel,com.viwilo.camel.producer,1,1578,0,1578,12,1578.0
camel,org.apache.camel.processor.aggregate.tarfile,39,1287,287,1574,7,40.35897435897436
camel,test.java.org.apache.camel.component.soroushbot.component,1,0,1573,1573,22,1573.0
camel,org.apache.camel.component.iec60870,28,1425,147,1572,12,56.142857142857146
camel,org.apache.camel.support.processor.validation,19,1112,456,1568,29,82.52631578947368
camel,org.apache.camel.cdi.transaction,47,709,856,1565,24,33.297872340425535
camel,org.apache.camel.component.sip.listener,16,781,781,1562,4,97.625
camel,org.apache.camel.component.workday,40,1116,445,1561,8,39.025
camel,org.apache.camel.component.hazelcast.map,59,1119,438,1557,7,26.389830508474578
camel,org.apache.camel.eclipse.parser,2,1454,102,1556,6,778.0
camel,org.apache.camel.component.aws2.athena.integration,7,988,567,1555,2,222.14285714285714
camel,generated.java.org.apache.camel.component.vertx.kafka,2,0,1554,1554,4,777.0
camel,org.apache.camel.component.jsonata,33,1299,249,1548,15,46.90909090909091
camel,org.apache.camel.impl.transformer,31,1171,377,1548,13,49.935483870967744
camel,org.apache.camel.maven.generator.openapi,40,1228,319,1547,7,38.675
camel,org.apache.camel.component.quartz.springboot,17,627,917,1544,6,90.82352941176471
camel,org.apache.camel.component.gridfs,15,1298,242,1540,18,102.66666666666667
camel,org.apache.camel.component.jackson.converter,46,1247,287,1534,9,33.34782608695652
camel,org.apache.camel.dataformat.soap.springboot,30,767,767,1534,6,51.13333333333333
camel,org.apache.camel.component.atomix.cluster,29,496,1036,1532,15,52.827586206896555
camel,org.apache.camel.tools.apt.model,23,766,766,1532,5,66.6086956521739
camel,org.apache.camel.component.ignite.cache,37,1328,202,1530,8,41.351351351351354
camel,org.apache.camel.metrics,12,1293,234,1527,20,127.25
camel,org.apache.camel.component.servicenow.model,7,1075,451,1526,22,218.0
camel,org.apache.camel.component.etcd.cloud,23,865,657,1522,10,66.17391304347827
camel,org.apache.camel.rx.support,21,761,761,1522,12,72.47619047619048
camel,org.apache.camel.spring.example,51,1212,309,1521,29,29.823529411764707
camel,test.java.org.apache.camel.component.thymeleaf,1,0,1516,1516,11,1516.0
camel,test.java.org.apache.camel.component.openshift,2,0,1514,1514,25,757.0
camel,org.apache.camel.component.jbpm.listeners,4,757,757,1514,3,378.5
camel,org.apache.camel.component.dapr.operations,5,1509,5,1514,15,302.8
camel,org.apache.camel.component.kubernetes.customresources,31,1216,296,1512,7,48.774193548387096
camel,org.apache.camel.component.weaviate,9,1419,92,1511,13,167.88888888888889
camel,org.apache.camel.maven.connector.model,8,754,754,1508,5,188.5
camel,org.apache.camel.component.event,96,1091,411,1502,12,15.645833333333334
camel,test.java.org.apache.camel.dataformat.beanio,1,0,1502,1502,17,1502.0
camel,org.apache.camel.component.aws.lambda.springboot,16,751,751,1502,4,93.875
camel,org.apache.camel.test.infra.kafka.services,54,1114,387,1501,20,27.796296296296298
camel,org.apache.camel.dsl.jbang.it,45,1387,111,1498,24,33.28888888888889
camel,org.apache.camel.component.quickfix,11,749,749,1498,8,136.1818181818182
camel,org.apache.camel.dataformat.mime.multipart,38,1257,236,1493,3,39.28947368421053
camel,org.apache.camel.dataformat.beanio.springboot,33,746,746,1492,6,45.21212121212121
camel,org.apache.camel.component.zookeepermaster.group,24,1126,363,1489,12,62.041666666666664
camel,test.java.org.apache.camel.component.aws.mq,2,0,1488,1488,11,744.0
camel,org.apache.camel.component.mybatis.springboot,33,743,743,1486,8,45.03030303030303
camel,org.apache.camel.component.google.bigquery.integration,23,1334,151,1485,15,64.56521739130434
camel,org.apache.camel.component.tahu.handlers,2,1480,4,1484,11,742.0
camel,org.apache.camel.language.jxpath,36,1049,434,1483,14,41.19444444444444
camel,org.apache.camel.component.http4.springboot,49,960,523,1483,8,30.26530612244898
camel,org.apache.camel.maven.htmlxlsx.process,8,1464,18,1482,11,185.25
camel,org.apache.camel.component.eventadmin,44,823,657,1480,10,33.63636363636363
camel,main.resources.archetype-resources.__artifactId__-component.src.main.java,21,887,591,1478,10,70.38095238095238
camel,org.apache.camel.component.file.stress,35,1032,445,1477,27,42.2
camel,org.apache.camel.component.kubernetes.persistent_volumes_claims,54,939,538,1477,6,27.35185185185185
camel,test.java.org.apache.camel.component.properties,3,0,1475,1475,16,491.6666666666667
camel,org.apache.camel.component.infinispan.processor.aggregate,23,1058,413,1471,7,63.95652173913044
camel,org.apache.camel.component.lucene.springboot,34,735,735,1470,6,43.23529411764706
camel,generated.java.org.apache.camel.component.google.drive.internal,3,0,1470,1470,20,490.0
camel,org.apache.camel.component.gae.mail,29,965,498,1463,11,50.44827586206897
camel,org.apache.camel.itest.ftp,33,949,511,1460,5,44.24242424242424
camel,org.apache.camel.cdi.internal,26,303,1157,1460,8,56.15384615384615
camel,org.apache.camel.component.browse,83,1036,423,1459,19,17.57831325301205
camel,org.apache.camel.component.jetty.rest.producer,33,1197,262,1459,28,44.21212121212121
camel,org.apache.camel.component.sjms.reply,13,1312,145,1457,12,112.07692307692308
camel,test.java.org.apache.camel.builder.script,4,0,1451,1451,22,362.75
camel,org.apache.camel.dataformat.castor,17,964,487,1451,9,85.3529411764706
camel,org.apache.camel.component.micrometer.messagehistory,38,1145,302,1447,9,38.078947368421055
camel,org.apache.camel.component.whatsapp,9,1283,162,1445,13,160.55555555555554
camel,org.apache.camel.component.salesforce.codegen,17,1369,74,1443,6,84.88235294117646
camel,org.apache.camel.component.knative.spi,11,1298,144,1442,12,131.0909090909091
camel,org.apache.camel.mdc,5,1285,157,1442,12,288.4
camel,org.apache.camel.component.aws.iam.springboot,14,720,720,1440,4,102.85714285714286
camel,org.apache.camel.component.aws2.s3.localstack,27,1354,82,1436,14,53.18518518518518
camel,org.apache.camel.example.rest,22,717,717,1434,13,65.18181818181819
camel,org.apache.camel.component.mina.springboot,10,436,997,1433,4,143.3
camel,org.apache.camel.component.spring.security,49,1113,320,1433,11,29.244897959183675
camel,org.apache.camel.component.openstack.it,4,1407,25,1432,16,358.0
camel,org.apache.camel.dataformat.asn1,31,1224,205,1429,10,46.096774193548384
camel,org.apache.camel.component.jms.async,43,1131,298,1429,9,33.23255813953488
camel,org.apache.camel.component.nagios.springboot,40,714,714,1428,6,35.7
camel,org.apache.camel.component.aws.kms.springboot,15,714,714,1428,4,95.2
camel,org.apache.camel.component.aws.ecs.springboot,13,713,713,1426,4,109.6923076923077
camel,org.apache.camel.component.aws.mq.springboot,14,713,713,1426,4,101.85714285714286
camel,org.apache.camel.dataformat.castor.springboot,31,712,712,1424,6,45.935483870967744
camel,test.java.org.apache.camel.component.aws.sns,2,0,1423,1423,13,711.5
camel,test.java.org.apache.camel.spring.processor,15,0,1417,1417,35,94.46666666666667
camel,org.apache.camel.component.git.consumer,44,943,473,1416,7,32.18181818181818
camel,org.apache.camel.component.twitter.mocks,4,1414,1,1415,3,353.75
camel,org.apache.camel.oaipmh.component,33,1102,312,1414,7,42.84848484848485
camel,org.apache.camel.example.cdi,40,782,632,1414,11,35.35
camel,test.java.org.apache.camel.component.twitter.mocks,1,0,1413,1413,3,1413.0
camel,org.apache.camel.component.yammer.springboot,33,706,706,1412,6,42.78787878787879
camel,org.apache.camel.itest.async,58,1140,271,1411,12,24.32758620689655
camel,test.java.org.apache.camel.component.rest.openapi,3,0,1409,1409,7,469.6666666666667
camel,org.apache.camel.component.cxf.jaxrs.simplebinding,22,1157,251,1408,6,64.0
camel,org.apache.camel.component.metrics.routepolicy,42,1154,253,1407,8,33.5
camel,org.apache.camel.component.cbor,24,1211,196,1407,9,58.625
camel,org.apache.camel.dataformat.mime.multipart.springboot,33,702,702,1404,6,42.54545454545455
camel,org.apache.camel.component.hashicorp.vault,40,1259,142,1401,11,35.025
camel,org.apache.camel.component.influxdb2,10,1383,18,1401,14,140.1
camel,test.java.org.apache.camel.test.infra.activemq.services,1,0,1400,1400,9,1400.0
camel,org.apache.camel.component.web3j.springboot,16,700,700,1400,2,87.5
camel,org.apache.camel.component.johnzon,25,1034,361,1395,12,55.8
camel,org.apache.camel.component.zeebe,12,1370,25,1395,13,116.25
camel,org.apache.camel.component.aws2.eventbridge.localstack,32,1241,153,1394,21,43.5625
camel,org.apache.camel.component.kubernetes.resources_quota,52,893,500,1393,6,26.78846153846154
camel,org.apache.camel.component.sap.netweaver,60,1034,358,1392,10,23.2
camel,org.apache.camel.component.cm.test.mocks.cmsender,4,828,558,1386,18,346.5
camel,org.apache.camel.component.kubernetes.cloud,27,1079,307,1386,17,51.333333333333336
camel,org.apache.camel.component.kubernetes.secrets,55,893,491,1384,6,25.163636363636364
camel,org.apache.camel.component.azure.storage.datalake.integration,14,1342,41,1383,17,98.78571428571429
camel,org.apache.camel.component.service,42,971,404,1375,7,32.73809523809524
camel,org.apache.camel.model.config,66,962,412,1374,20,20.818181818181817
camel,org.apache.camel.model.app,27,1043,331,1374,11,50.888888888888886
camel,org.apache.camel.component.test,95,1095,275,1370,28,14.421052631578947
camel,org.apache.camel.component.hazelcast.springboot,25,685,685,1370,6,54.8
camel,org.apache.camel.processor.resume,25,917,452,1369,6,54.76
camel,org.apache.camel.component.langchain4j.chat,22,952,415,1367,19,62.13636363636363
camel,org.apache.camel.component.aws2.ddb.localstack,19,1312,54,1366,11,71.89473684210526
camel,org.apache.camel.component.kubernetes.service_accounts,55,882,482,1364,6,24.8
camel,test.java.org.apache.camel.component.web3j,2,0,1363,1363,13,681.5
camel,test.java.org.apache.camel.component.aws.swf,2,0,1361,1361,21,680.5
camel,test.java.org.apache.camel.itest.springboot.util,2,0,1360,1360,7,680.0
camel,org.apache.camel.dsl.jbang.core.commands.version,42,1103,256,1359,6,32.357142857142854
camel,test.java.org.apache.camel.processor.async,5,0,1359,1359,11,271.8
camel,org.apache.camel.test.infra.jetty.services,20,1089,265,1354,4,67.7
camel,org.apache.camel.component.file.remote.sftp.integration,30,896,457,1353,45,45.1
camel,org.apache.camel.component.as2.springboot,18,676,676,1352,2,75.11111111111111
camel,tooling.camel-eclipse.camel.routing.src-gen.org.apache.camel.eclipse.parser,1,0,1352,1352,3,1352.0
camel,org.apache.camel.component.stomp.springboot,36,676,676,1352,6,37.55555555555556
camel,test.java.org.apache.camel.component.olingo2,1,0,1350,1350,4,1350.0
camel,org.apache.camel.component.cxf.jaxrs.simplebinding.testbean,10,1210,140,1350,27,135.0
camel,org.apache.camel.component.atmosphere.websocket.springboot,41,674,674,1348,6,32.8780487804878
camel,org.apache.camel.component.drill,53,1012,336,1348,10,25.433962264150942
camel,org.apache.camel.component.azure.storage.blob.client,14,885,463,1348,8,96.28571428571429
camel,org.apache.camel.component.zookeeper.ha,14,1161,181,1342,10,95.85714285714286
camel,org.apache.camel.component.as2.api.protocol,32,949,388,1337,4,41.78125
camel,org.apache.camel.component.quickfixj.examples,28,978,358,1336,5,47.714285714285715
camel,org.apache.camel.util.jndi,32,1041,290,1331,6,41.59375
camel,org.apache.camel.component.smpp.integration,26,1060,271,1331,10,51.19230769230769
camel,org.apache.camel.component.clickup,5,1307,23,1330,14,266.0
camel,org.apache.camel.component.google.secret.manager,47,1247,80,1327,20,28.23404255319149
camel,org.apache.camel.zipkin.starter,14,662,662,1324,12,94.57142857142857
camel,org.apache.camel.component.grape,43,982,341,1323,12,30.767441860465116
camel,org.apache.camel.component.infinispan.remote.cluster,13,1203,116,1319,11,101.46153846153847
camel,org.apache.camel.component.langchain4j.agent.integration,10,1025,294,1319,12,131.9
camel,org.apache.camel.component.jetty.async,35,1044,274,1318,26,37.65714285714286
camel,org.apache.camel.component.elasticsearch.converter,52,585,730,1315,3,25.28846153846154
camel,org.apache.camel.component.mail.stream,3,987,328,1315,5,438.3333333333333
camel,org.apache.camel.component.redis.processor.idempotent,35,968,346,1314,12,37.542857142857144
camel,org.apache.camel.processor.idempotent.jpa,47,855,459,1314,4,27.95744680851064
camel,org.apache.camel.itest.sql,35,808,504,1312,2,37.48571428571429
camel,org.apache.camel.dataformat.bindy.kvp.springboot,41,656,656,1312,6,32.0
camel,org.apache.camel.dataformat.bindy.fixed.springboot,41,656,656,1312,6,32.0
camel,org.apache.camel.component.netty4.http.handlers,38,1015,296,1311,4,34.5
camel,org.apache.camel.component.telegram.integration,29,1063,248,1311,4,45.206896551724135
camel,org.apache.camel.component.azure.storage.datalake.client,9,879,431,1310,10,145.55555555555554
camel,org.apache.camel.component.google.sheets.transform,5,1254,56,1310,5,262.0
camel,org.apache.camel.component.aws2.timestream,10,1290,19,1309,12,130.9
camel,org.apache.camel.component.ahc.ws.springboot,46,653,653,1306,6,28.391304347826086
camel,org.apache.camel.component.azure.servicebus.integration,10,1259,46,1305,6,130.5
camel,org.apache.camel.component.bonita,45,915,388,1303,7,28.955555555555556
camel,org.apache.camel.component.milvus,16,1207,95,1302,18,81.375
camel,org.apache.camel.component.jira.springboot,23,651,651,1302,5,56.608695652173914
camel,org.apache.camel.dataformat.bindy.csv.springboot,41,650,650,1300,6,31.70731707317073
camel,org.apache.camel.test.oauth,8,1199,101,1300,11,162.5
camel,test.java.org.apache.camel.component.atlasmap,1,0,1298,1298,16,1298.0
camel,org.apache.camel.component.aws2.bedrock.runtime.integration,23,1176,121,1297,2,56.391304347826086
camel,org.apache.camel.component.langchain.embeddings,7,1184,111,1295,30,185.0
camel,org.apache.camel.component.disruptor.vm.springboot,37,645,645,1290,6,34.86486486486486
camel,org.apache.camel.component.milo.client.springboot,23,644,644,1288,2,56.0
camel,test.java.org.apache.camel.component.crypto.cms,1,0,1287,1287,5,1287.0
camel,org.apache.camel.component.disruptor.springboot,36,643,643,1286,6,35.72222222222222
camel,test.java.org.apache.camel.component.sparkrest,2,0,1286,1286,24,643.0
camel,org.apache.camel.component.stitch,13,1258,26,1284,12,98.76923076923077
camel,org.apache.camel.model.rest.springboot,28,618,665,1283,4,45.82142857142857
camel,org.apache.camel.itest.ibatis,10,1202,80,1282,13,128.2
camel,org.apache.camel.component.jetty8,13,615,667,1282,13,98.61538461538461
camel,org.apache.camel.core.xml.scan,5,866,415,1281,2,256.2
camel,org.apache.camel.component.ahc.springboot,35,640,640,1280,6,36.57142857142857
camel,org.apache.camel.component.vertx.common,17,1112,168,1280,16,75.29411764705883
camel,org.apache.camel.component.elasticsearch.springboot,33,478,800,1278,8,38.72727272727273
camel,test.java.org.apache.camel.spring.boot.actuate.endpoint,2,0,1277,1277,14,638.5
camel,org.apache.camel.component.quickfixj.examples.trading,31,1042,231,1273,5,41.064516129032256
camel,org.apache.camel.cluster,24,1045,220,1265,24,52.708333333333336
camel,org.apache.camel.converter.xmlbeans,22,904,361,1265,8,57.5
camel,org.apache.camel.component.aws2.bedrock.agentruntime,6,1242,19,1261,10,210.16666666666666
camel,org.apache.camel.component.infinispan.springboot,33,630,630,1260,3,38.18181818181818
camel,org.apache.camel.component.kamelet.utils.transform,2,1243,12,1255,15,627.5
camel,org.apache.camel.component.docker.it,31,1020,234,1254,9,40.45161290322581
camel,test.java.org.apache.camel.component.ibatis,2,0,1253,1253,18,626.5
camel,org.apache.camel.component.docker.consumer,30,809,444,1253,4,41.766666666666666
camel,org.apache.camel.component.minio.integration,13,1098,154,1252,23,96.3076923076923
camel,org.apache.camel.dataformat.barcode.springboot,30,626,626,1252,6,41.733333333333334
camel,org.apache.camel.component.activemq.converter,25,952,300,1252,7,50.08
camel,org.apache.camel.component.dropbox.core,21,803,449,1252,1,59.61904761904762
camel,test.java.org.apache.camel.component.beanstalk,2,0,1248,1248,11,624.0
camel,org.apache.camel.component.lumberjack.io,15,1050,198,1248,12,83.2
camel,org.apache.camel.component.jclouds.springboot,18,634,614,1248,6,69.33333333333333
camel,org.apache.camel.component.soroushbot.utils,9,711,536,1247,10,138.55555555555554
camel,org.apache.camel.dataformat.parquet.avro,11,1197,46,1243,13,113.0
camel,test.java.org.apache.camel.component.rest.swagger,1,0,1243,1243,10,1243.0
camel,org.apache.camel.component.hazelcast.list,52,909,332,1241,7,23.865384615384617
camel,org.apache.camel.component.soroushbot.models,5,620,620,1240,6,248.0
camel,org.apache.camel.component.ref,82,889,349,1238,13,15.097560975609756
camel,org.apache.camel.itest.issues,54,949,288,1237,13,22.90740740740741
camel,org.springframework.ws.soap.addressing.server,3,618,618,1236,1,412.0
camel,org.apache.camel.example.client,34,572,663,1235,9,36.3235294117647
camel,org.apache.camel.component.smb2,2,659,575,1234,7,617.0
camel,org.apache.camel.itest.osgi.protobuf.generated,1,1232,0,1232,1,1232.0
camel,test.java.org.apache.camel.component.netty.http.rest,1,0,1228,1228,19,1228.0
camel,org.apache.camel.component.metrics.messagehistory,32,1065,160,1225,8,38.28125
camel,org.apache.camel.component.telegram.util,39,998,226,1224,7,31.384615384615383
camel,org.apache.camel.component.olingo2.api,13,1050,173,1223,3,94.07692307692308
camel,org.apache.camel.component.jbpm.server,23,688,533,1221,3,53.08695652173913
camel,org.apache.camel.processor.binding,38,840,380,1220,4,32.10526315789474
camel,org.apache.camel.itest,41,1040,176,1216,16,29.658536585365855
camel,org.apache.camel.component.jms.temp,54,825,391,1216,6,22.51851851851852
camel,org.apache.camel.component.etcd.processor.remote,5,756,459,1215,8,243.0
camel,org.apache.camel.language.xpath.springboot,25,607,607,1214,7,48.56
camel,org.apache.camel.example.gae,12,607,607,1214,6,101.16666666666667
camel,org.apache.camel.component.reactive.streams.api,20,811,403,1214,4,60.7
camel,org.apache.camel.component.milo.server.springboot,22,607,607,1214,2,55.18181818181818
camel,generated.java.org.apache.camel.component.kafka,1,0,1211,1211,3,1211.0
camel,org.apache.camel.component.neo4j.it,5,875,335,1210,2,242.0
camel,org.apache.camel.component.langchain4j.agent.api,14,1085,122,1207,14,86.21428571428571
camel,org.apache.camel.component.pulsar.integration,21,885,322,1207,19,57.476190476190474
camel,org.apache.camel.dataformat.base64.springboot,33,603,603,1206,6,36.54545454545455
camel,test.java.org.apache.camel.routepolicy.quartz,1,0,1206,1206,12,1206.0
camel,org.apache.camel.language.tokenizer.springboot,24,695,509,1204,12,50.166666666666664
camel,org.apache.camel.component.consul.endpoint,25,722,480,1202,31,48.08
camel,org.apache.camel.component.hazelcast.multimap,51,866,335,1201,7,23.54901960784314
camel,org.apache.camel.component.cometd.springboot,37,600,600,1200,6,32.432432432432435
camel,org.apache.camel.component.spring.batch.springboot,32,600,600,1200,6,37.5
camel,org.apache.camel.component.dns.policy,21,805,394,1199,4,57.095238095238095
camel,org.apache.camel.component.dataformat,77,921,276,1197,13,15.545454545454545
camel,org.apache.camel.component.etcd.springboot,29,597,597,1194,3,41.172413793103445
camel,org.apache.camel.component.twitter.consumer,28,754,438,1192,10,42.57142857142857
camel,jakarta,14,596,596,1192,1,85.14285714285714
camel,org.apache.camel.component.azure.blob.springboot,20,592,592,1184,2,59.2
camel,org.apache.camel.component.undertow.springboot,36,591,591,1182,6,32.833333333333336
camel,org.apache.camel.spring.processor.onexception,35,999,180,1179,23,33.68571428571428
camel,org.apache.camel.component.http.handler,21,1041,136,1177,13,56.04761904761905
camel,org.apache.camel.component.vertx.springboot,31,588,588,1176,6,37.935483870967744
camel,org.apache.camel.component.twitter.data,15,652,524,1176,8,78.4
camel,org.apache.camel.component.quickfixj.springboot,36,586,586,1172,6,32.55555555555556
camel,test.java.org.apache.camel.test.issues,4,0,1170,1170,16,292.5
camel,org.apache.camel.component.digitalocean,52,717,452,1169,9,22.48076923076923
camel,org.apache.camel.converter.soap.name,23,1003,164,1167,14,50.73913043478261
camel,org.apache.camel.component.ignite.compute,29,998,168,1166,7,40.206896551724135
camel,org.apache.camel.component.chatscript,40,924,241,1165,11,29.125
camel,org.apache.camel.component.hazelcast.topic,49,850,312,1162,8,23.714285714285715
camel,org.apache.camel.component.kubernetes.persistent_volumes,47,772,385,1157,6,24.617021276595743
camel,org.apache.camel.component.sjms2.springboot,20,578,578,1156,2,57.8
camel,org.apache.camel.language.ognl,48,902,254,1156,13,24.083333333333332
camel,org.apache.camel.component.solr.integration,6,1130,17,1147,6,191.16666666666666
camel,test.java.org.apache.camel.component.milo.call,4,0,1145,1145,5,286.25
camel,org.apache.camel.component.etcd3.policy,7,648,496,1144,3,163.42857142857142
camel,org.apache.camel.component.paxlogging,41,649,495,1144,8,27.902439024390244
camel,org.apache.camel.component.ehcache.springboot.customizer,8,784,358,1142,21,142.75
camel,org.apache.camel.component.kubernetes.consumer.integration,12,818,317,1135,8,94.58333333333333
camel,org.apache.camel.maven.config,31,889,245,1134,19,36.58064516129032
camel,org.apache.camel.component.atmos.integration.producer,14,806,327,1133,12,80.92857142857143
camel,test.java.org.apache.camel.test.cdi,5,0,1132,1132,18,226.4
camel,org.apache.camel.component.google.pubsub.consumer,20,715,417,1132,10,56.6
camel,test.java.org.apache.camel.component.corda,1,0,1131,1131,14,1131.0
camel,org.apache.camel.component.flowable,3,1126,4,1130,16,376.6666666666667
camel,org.apache.camel.component.beanclass.springboot,27,564,564,1128,5,41.77777777777778
camel,org.apache.camel.component.elasticsearch5.springboot,18,724,402,1126,4,62.55555555555556
camel,org.apache.camel.impl.osgi,43,882,243,1125,1,26.162790697674417
camel,org.apache.camel.spring.cloud.servicecall,2,627,496,1123,5,561.5
camel,org.apache.camel.component.openshift.build_configs,49,715,407,1122,6,22.897959183673468
camel,org.apache.camel.component.hdfs.kerberos,21,695,427,1122,8,53.42857142857143
camel,test.java.org.apache.camel.itest.ibatis,1,0,1122,1122,13,1122.0
camel,org.apache.camel.tools.apt.helper,42,575,547,1122,5,26.714285714285715
camel,org.apache.camel.component.jackson.transform,6,1080,41,1121,11,186.83333333333334
camel,org.apache.camel.component.microprofile.metrics.event.notifier.exchange,14,702,416,1118,6,79.85714285714286
camel,org.apache.camel.component.cdi.util,5,558,558,1116,4,223.2
camel,org.apache.camel.component.twitter.springboot,26,557,557,1114,6,42.84615384615385
camel,org.apache.camel.dataformat.zipfile.springboot,35,557,557,1114,6,31.82857142857143
camel,org.apache.camel.component.ibm.cos.integration,1,1113,0,1113,7,1113.0
camel,org.apache.camel.component.dropbox.integration.consumer,26,752,361,1113,8,42.80769230769231
camel,org.apache.camel.component.hazelcast.set,45,817,294,1111,7,24.68888888888889
camel,org.apache.camel.component.aws2.bedrock.runtime.stream,2,1110,0,1110,12,555.0
camel,org.apache.camel.dataformat.tarfile.springboot,33,555,555,1110,6,33.63636363636363
camel,org.apache.camel.impl.validator,23,927,183,1110,17,48.26086956521739
camel,org.apache.camel.component.hazelcast.replicatedmap,45,813,296,1109,7,24.644444444444446
camel,test.java.org.apache.camel.component.jbpm.workitem,3,0,1108,1108,6,369.3333333333333
camel,org.apache.camel.language.mvel,41,978,127,1105,14,26.951219512195124
camel,org.apache.camel.component.crypto.cms.common,11,552,552,1104,9,100.36363636363636
camel,org.apache.camel.component.jpa.springboot,34,551,551,1102,6,32.411764705882355
camel,test.java.org.apache.camel.component.microprofile.faulttolerance,1,0,1101,1101,15,1101.0
camel,org.apache.camel.component.boon.springboot,30,550,550,1100,6,36.666666666666664
camel,org.apache.camel.component.hdfs.springboot,30,453,646,1099,6,36.63333333333333
camel,org.apache.camel.component.wordpress.api.service.impl,15,984,115,1099,12,73.26666666666667
camel,org.apache.camel.component.validator.springboot,30,549,549,1098,8,36.6
camel,org.apache.camel.dataformat.jibx.springboot,29,549,549,1098,6,37.86206896551724
camel,org.apache.camel.dataformat.tagsoup.springboot,33,549,549,1098,6,33.27272727272727
camel,org.apache.camel.component.bean.springboot,26,527,570,1097,5,42.19230769230769
camel,test.java.org.apache.camel.component.directvm,1,0,1097,1097,12,1097.0
camel,generated.java.org.apache.camel.component.google.sheets,1,0,1095,1095,8,1095.0
camel,org.apache.camel.component.google.sheets.internal,21,880,215,1095,12,52.142857142857146
camel,org.apache.camel.component.kubernetes.ha,12,964,130,1094,4,91.16666666666667
camel,test.java.org.apache.camel.component.rabbitmq,2,0,1093,1093,9,546.5
camel,org.apache.camel.component.openshift.builds,48,704,389,1093,6,22.770833333333332
camel,org.apache.camel.component.ignite.queue,29,885,207,1092,7,37.6551724137931
camel,org.apache.camel.impl.osgi.tracker,10,34,1058,1092,3,109.2
camel,org.apache.camel.itest.springboot.command,8,545,545,1090,6,136.25
camel,org.apache.camel.component.openstack.nova.producer,11,731,357,1088,3,98.9090909090909
camel,org.apache.camel.component.openstack.swift.producer,12,721,366,1087,2,90.58333333333333
camel,org.apache.camel.component.scheduler.springboot,31,543,543,1086,8,35.03225806451613
camel,org.apache.camel.springboot.commands.crsh,6,543,543,1086,8,181.0
camel,org.apache.camel.component.consul.ha,9,1016,70,1086,9,120.66666666666667
camel,org.apache.camel.component.langchain4j.embeddingstore,5,1024,58,1082,12,216.4
camel,org.apache.camel.spring.javaconfig.test,40,773,307,1080,9,27.0
camel,org.apache.camel.dsl.xml.jaxb,24,870,209,1079,10,44.958333333333336
camel,org.apache.camel.dataformat.avro,45,925,153,1078,10,23.955555555555556
camel,org.apache.camel.component.olingo4.springboot,22,538,538,1076,2,48.90909090909091
camel,test.java.org.apache.camel.component.elasticsearch.integration,1,0,1075,1075,8,1075.0
camel,org.apache.camel.itest.doc,17,529,546,1075,20,63.23529411764706
camel,org.apache.camel.component.browse.springboot,25,537,537,1074,5,42.96
camel,org.apache.camel.dataformat.protobuf.springboot,34,537,537,1074,6,31.58823529411765
camel,org.apache.camel.language.simple.springboot,21,537,537,1074,10,51.142857142857146
camel,org.apache.camel.component.aws.sdb.springboot,24,536,536,1072,5,44.666666666666664
camel,org.apache.camel.component.dataformat.springboot,25,536,536,1072,5,42.88
camel,org.apache.camel.component.controlbus.springboot,25,536,536,1072,5,42.88
camel,generated.java.org.apache.camel.converter.aries,1,0,1072,1072,19,1072.0
camel,org.apache.camel.example.etl,30,566,506,1072,7,35.733333333333334
camel,org.apache.camel.component.flink.springboot,29,536,536,1072,6,36.96551724137931
camel,org.apache.camel.component.chat,3,1000,71,1071,23,357.0
camel,org.apache.camel.component.file.springboot,25,535,535,1070,5,42.8
camel,org.apache.camel.component.jsonb,15,1008,61,1069,11,71.26666666666667
camel,org.apache.camel.component.elsql.springboot,30,534,534,1068,6,35.6
camel,org.apache.camel.resume,27,810,256,1066,19,39.48148148148148
camel,org.apache.camel.spring.model.language,7,460,604,1064,14,152.0
camel,org.apache.camel.component.consul.springboot.cloud,14,777,286,1063,9,75.92857142857143
camel,org.apache.camel.maven.connector.util,10,51,1010,1061,5,106.1
camel,org.apache.camel.component.clickup.model,2,1060,1,1061,14,530.5
camel,org.apache.camel.component.bonita.api,20,750,311,1061,7,53.05
camel,org.apache.camel.loanbroker.webservice.version,32,700,359,1059,10,33.09375
camel,org.apache.camel.component.ibm.watson.discovery,1,1056,0,1056,10,1056.0
camel,test.java.org.apache.camel.component.azure.storage.blob.integration,1,0,1056,1056,5,1056.0
camel,org.apache.camel.component.tensorflow.serving,4,1039,14,1053,11,263.25
camel,org.apache.camel.component.ibm.secrets.manager,8,994,56,1050,10,131.25
camel,org.apache.camel.language.juel,35,622,428,1050,8,30.0
camel,org.apache.camel.component.azure.common,13,776,273,1049,6,80.6923076923077
camel,org.apache.camel.component.torchserve.client.model,2,1048,0,1048,12,524.0
camel,org.apache.camel.component.jte,7,1033,13,1046,13,149.42857142857142
camel,org.apache.camel.component.langchain4j.web.search,3,1037,9,1046,12,348.6666666666667
camel,org.apache.camel.component.routebox.seda,21,523,523,1046,3,49.80952380952381
camel,org.apache.camel.main.parser,8,853,192,1045,8,130.625
camel,org.apache.camel.maven.bom.generator,36,871,174,1045,5,29.02777777777778
camel,org.apache.camel.ha,15,723,321,1044,11,69.6
camel,test.java.org.apache.camel.component.dynamicrouter,3,0,1044,1044,11,348.0
camel,org.apache.camel.component.micrometer.prometheus,21,886,156,1042,3,49.61904761904762
camel,org.apache.camel.swagger.servlet,24,492,547,1039,4,43.291666666666664
camel,org.apache.camel.component.dataset.springboot,24,427,610,1037,7,43.208333333333336
camel,org.apache.camel.oaipmh,7,793,242,1035,8,147.85714285714286
camel,org.apache.camel.component.resteasy.test.beans,4,953,82,1035,13,258.75
camel,org.apache.camel.processor.transformer,23,951,84,1035,16,45.0
camel,test.java.org.apache.camel.builder,8,0,1034,1034,11,129.25
camel,org.apache.camel.component.google.storage.unit,18,927,107,1034,11,57.44444444444444
camel,org.apache.camel.example.cdi.osgi,10,736,297,1033,6,103.3
camel,org.apache.camel.component.context,23,608,425,1033,7,44.91304347826087
camel,org.apache.camel.component.quartz2.springboot,35,672,359,1031,8,29.457142857142856
camel,org.apache.camel.component.pqc.dataformat,1,1031,0,1031,6,1031.0
camel,org.apache.camel.util.blueprint,6,515,515,1030,8,171.66666666666666
camel,generated.java.org.apache.camel.component.facebook,1,0,1030,1030,3,1030.0
camel,org.apache.camel.dataformat.xmlrpc.springboot,29,515,515,1030,6,35.51724137931034
camel,org.apache.camel.dsl.jbang.core.commands.update,7,1006,23,1029,9,147.0
camel,org.apache.camel.component.google.secret.manager.integration,27,911,118,1029,5,38.111111111111114
camel,org.apache.camel.yaml.io,19,958,70,1028,3,54.10526315789474
camel,org.apache.camel.dataformat.hessian.springboot,29,514,514,1028,6,35.44827586206897
camel,org.apache.camel.dataformat.lzf.springboot,30,514,514,1028,6,34.266666666666666
camel,test.java.org.apache.camel.spring.remoting,2,0,1027,1027,28,513.5
camel,org.apache.camel.component.ical.springboot,30,513,513,1026,6,34.2
camel,org.apache.camel.converter.xmlbeans.springboot,27,513,513,1026,6,38.0
camel,org.apache.camel.example.guice.jms,24,552,474,1026,9,42.75
camel,org.apache.camel.dataformat.avro.springboot,29,513,513,1026,6,35.37931034482759
camel,main.resources.archetype-resources.src.test.java,27,600,423,1023,16,37.888888888888886
camel,org.apache.camel.component.splunk.support,24,873,150,1023,7,42.625
camel,org.apache.camel.component.keycloak.security.cache,1,1021,0,1021,8,1021.0
camel,org.apache.camel.component.jackson.avro.transform,7,993,26,1019,10,145.57142857142858
camel,test.java.org.apache.camel.component.google.pubsub.integration,2,0,1019,1019,9,509.5
camel,org.apache.camel.component.sjms.batch.springboot,32,509,509,1018,6,31.8125
camel,org.apache.camel.component.binding,21,509,509,1018,5,48.476190476190474
camel,test.java.org.apache.camel.component.hdfs.integration,2,0,1018,1018,5,509.0
camel,org.apache.camel.component.kestrel.springboot,27,508,508,1016,6,37.629629629629626
camel,org.apache.camel.component.plc4x,28,670,346,1016,18,36.285714285714285
camel,test.java.org.apache.camel.component.aws.eks,2,0,1016,1016,11,508.0
camel,org.apache.camel.cdi.jta,1,1015,0,1015,13,1015.0
camel,org.apache.camel.component.jgroups.springboot,36,507,507,1014,6,28.166666666666668
camel,org.apache.camel.component.kubernetes.consumer.common,16,530,483,1013,9,63.3125
camel,org.apache.camel.component.google.functions.unit,12,858,154,1012,6,84.33333333333333
camel,org.apache.camel.component.hazelcast.atomicnumber,45,729,282,1011,6,22.466666666666665
camel,org.apache.camel.impl.scan,25,905,105,1010,15,40.4
camel,generated.java.org.apache.camel.component.etcd,1,0,1010,1010,9,1010.0
camel,org.apache.camel.impl.engine.springboot,2,760,247,1007,8,503.5
camel,org.apache.camel.component.bonita.api.util,17,665,341,1006,4,59.1764705882353
camel,org.apache.camel.spring.processor.aggregator,25,842,163,1005,21,40.2
camel,org.apache.camel.component.cxf.common.message,34,703,300,1003,12,29.5
camel,test.java.org.apache.camel.core.osgi,2,0,1003,1003,13,501.5
camel,test.java.org.apache.camel.component.ehcache.springboot.customizer,1,0,1001,1001,17,1001.0
camel,org.apache.camel.component.kubernetes.cluster.lock,17,581,420,1001,8,58.88235294117647
camel,org.apache.camel.component.ibm.watson.language,1,1000,0,1000,10,1000.0
camel,org.apache.camel.component.microprofile.config,33,660,339,999,4,30.272727272727273
camel,test.java.org.apache.camel.dataformat.xmljson,1,0,998,998,7,998.0
camel,org.apache.camel.component.dropbox.util,17,669,329,998,9,58.705882352941174
camel,org.apache.camel.component.undertow.spi,11,900,98,998,10,90.72727272727273
camel,test.java.org.apache.camel.component.aws.ecs,2,0,995,995,11,497.5
camel,org.apache.camel.component.openshift.deploymentconfigs,12,956,36,992,8,82.66666666666667
camel,org.apache.camel.component.dropbox.dto,12,585,407,992,6,82.66666666666667
camel,org.apache.camel.component.jackson.protobuf.transform,4,974,14,988,10,247.0
camel,org.apache.camel.component.azure.cosmosdb.operations,4,913,75,988,7,247.0
camel,org.apache.camel.component.stitch.client.models,3,981,6,987,11,329.0
camel,org.apache.camel.guice.inject,2,493,493,986,2,493.0
camel,org.apache.camel.component.etcd.policy,15,517,468,985,2,65.66666666666667
camel,org.apache.camel.component.cxf.springboot,32,491,491,982,6,30.6875
camel,org.apache.camel.component.fastjson.springboot,16,491,491,982,2,61.375
camel,org.apache.camel.component.microprofile.metrics.event.notifier.route,11,580,402,982,6,89.27272727272727
camel,org.apache.camel.guice.impl,18,490,490,980,4,54.44444444444444
camel,org.apache.camel.component.saga,45,746,234,980,12,21.77777777777778
camel,org.apache.camel.spring.cloud.netflix,6,624,356,980,9,163.33333333333334
camel,org.apache.camel.language.bean.springboot,25,490,490,980,7,39.2
camel,org.apache.camel.component.reactive.streams.springboot.test,8,653,325,978,4,122.25
camel,org.apache.camel.component.aws2.kinesis.consumer,15,673,303,976,11,65.06666666666666
camel,test.java.org.apache.camel.component.ehcache.springboot,1,0,976,976,13,976.0
camel,org.apache.camel.test.infra.ollama.services,12,796,179,975,10,81.25
camel,test.java.org.apache.camel.component.zookeeper.policy,1,0,973,973,6,973.0
camel,org.apache.camel.component.reactive.streams.springboot,24,486,486,972,3,40.5
camel,org.apache.camel.component.aws2.kinesis.integration,29,868,104,972,7,33.51724137931034
camel,org.apache.camel.component.as2.internal,37,745,227,972,8,26.27027027027027
camel,org.apache.camel.component.validator.msv,53,586,384,970,6,18.30188679245283
camel,org.apache.camel.util.function,22,858,112,970,29,44.09090909090909
camel,org.apache.camel.component.rest.swagger.springboot,27,484,484,968,2,35.851851851851855
camel,org.apache.camel.component.xquery.springboot,31,484,484,968,6,31.225806451612904
camel,org.apache.camel.component.djl.model.cv,4,664,302,966,14,241.5
camel,org.apache.camel.component.guava.eventbus.springboot,30,482,482,964,6,32.13333333333333
camel,org.apache.camel.component.feed,42,617,345,962,6,22.904761904761905
camel,org.apache.camel.component.syslog.springboot,30,481,481,962,6,32.06666666666667
camel,org.apache.camel.main.injection,23,797,162,959,3,41.69565217391305
camel,test.java.org.apache.camel.component.mqtt,1,0,958,958,12,958.0
camel,test.java.org.apache.camel.component.hbase,2,0,958,958,8,479.0
camel,org.apache.camel.guice.jndi.internal,2,479,479,958,2,479.0
camel,org.apache.camel.component.caffeine.load.springboot,18,478,478,956,2,53.111111111111114
camel,org.apache.camel.component.kameletreify,3,630,323,953,8,317.6666666666667
camel,org.apache.camel.component.validator.msv.springboot,29,476,476,952,6,32.827586206896555
camel,org.apache.camel.dataformat.rss.springboot,29,476,476,952,6,32.827586206896555
camel,org.apache.camel.component.sjms.pool,1,951,0,951,6,951.0
camel,org.apache.camel.component.hbase.mapping,15,475,475,950,4,63.333333333333336
camel,org.apache.camel.component.kubernetes.events,8,886,63,949,7,118.625
camel,org.apache.camel.component.spark.springboot,29,474,474,948,6,32.689655172413794
camel,org.apache.camel.component.kubernetes.cluster.utils,21,564,383,947,6,45.095238095238095
camel,org.apache.camel.dataformat.jibx,15,769,174,943,9,62.86666666666667
camel,org.apache.camel.component.hbase.springboot,31,470,470,940,6,30.322580645161292
camel,org.apache.camel.component.sql.springboot,32,470,470,940,6,29.375
camel,test.java.org.apache.camel.component.hipchat,2,0,940,940,9,470.0
camel,org.apache.camel.component.aws2.kinesis.client.impl,12,889,51,940,8,78.33333333333333
camel,test.java.org.apache.camel.component.milo,2,0,939,939,8,469.5
camel,org.apache.camel.component.twitter.consumer.streaming,15,704,233,937,7,62.46666666666667
camel,org.apache.camel.xml.io.util,15,644,292,936,5,62.4
camel,org.apache.camel.component.crypto.cms.springboot,14,468,468,936,2,66.85714285714286
camel,org.apache.camel.processor.saga,20,817,118,935,29,46.75
camel,org.apache.camel.component.azure.queue.springboot,19,467,467,934,2,49.1578947368421
camel,org.apache.camel.component.caffeine.cache.springboot,18,467,467,934,2,51.888888888888886
camel,org.apache.camel.component.beanstalk.integration,12,750,183,933,14,77.75
camel,org.apache.camel.component.extension,15,721,212,933,9,62.2
camel,org.apache.camel.builder.script.example,21,621,310,931,8,44.333333333333336
camel,org.apache.camel.component.hashicorp.vault.integration.operations,19,855,75,930,9,48.94736842105263
camel,test.java.org.apache.camel.component.jclouds,1,0,927,927,6,927.0
camel,org.apache.camel.component.pqc.crypto,10,825,101,926,14,92.6
camel,org.apache.camel.component.google.sheets.stream.springboot,12,463,463,926,2,77.16666666666667
camel,org.apache.camel.component.lumberjack.springboot,30,461,461,922,6,30.733333333333334
camel,org.apache.camel.component.event.springboot,30,461,461,922,6,30.733333333333334
camel,org.apache.camel.dataformat.bindy.kvp,51,595,326,921,2,18.058823529411764
camel,org.apache.camel.component.consul.policy,12,484,436,920,2,76.66666666666667
camel,org.apache.camel.component.infinispan.embedded.cluster,7,862,56,918,9,131.14285714285714
camel,org.apache.camel.component.cxf.jaxrs.springboot,31,459,459,918,6,29.612903225806452
camel,org.apache.camel.component.servicenow.releases.fuji,10,668,250,918,11,91.8
camel,test.java.org.apache.camel.component.elasticsearch5,1,0,917,917,6,917.0
camel,org.apache.camel.component.jsonapi,18,756,160,916,7,50.888888888888886
camel,org.apache.camel.example.cxf,30,641,274,915,7,30.5
camel,org.apache.camel.component.openshift.springboot,23,457,457,914,6,39.73913043478261
camel,org.apache.camel.metrics.counter,7,767,144,911,10,130.14285714285714
camel,org.apache.camel.loanbroker,14,233,678,911,15,65.07142857142857
camel,org.apache.camel.component.as2.api.io,12,733,178,911,3,75.91666666666667
camel,generated.java.org.apache.camel.component.rabbitmq,1,0,910,910,3,910.0
camel,org.apache.camel.reifier.rest,33,501,408,909,4,27.545454545454547
camel,test.java.org.apache.camel.test,3,0,909,909,13,303.0
camel,org.foo,20,461,447,908,16,45.4
camel,org.apache.camel.component.hazelcast.instance,43,661,247,908,6,21.11627906976744
camel,org.apache.camel.component.twitter.deprecated,10,848,59,907,14,90.7
camel,org.apache.camel.component.thrift.server,12,592,315,907,4,75.58333333333333
camel,org.apache.camel.jsonpath.springboot,29,453,453,906,6,31.24137931034483
camel,org.apache.camel.groovy.dataformat,7,453,453,906,6,129.42857142857142
camel,org.apache.camel.example.camel.transport,24,496,409,905,6,37.708333333333336
camel,org.apache.camel.component.zendesk.springboot,21,452,452,904,2,43.04761904761905
camel,org.apache.camel.wsdl_first,35,802,102,904,20,25.82857142857143
camel,test.java.org.apache.camel.cdi,2,0,903,903,14,451.5
camel,org.apache.camel.component.kserve,3,894,9,903,11,301.0
camel,org.apache.camel.component.beanstalk.springboot,29,451,451,902,6,31.103448275862068
camel,org.apache.camel.component.hazelcast.ringbuffer,38,658,244,902,6,23.736842105263158
camel,org.apache.camel.script.osgi,25,487,414,901,2,36.04
camel,org.foo.salesforce.contact.springboot,12,450,450,900,3,75.0
camel,org.apache.camel.component.atomix,19,479,420,899,7,47.31578947368421
camel,test.java.org.apache.camel.issues,7,0,899,899,9,128.42857142857142
camel,org.apache.camel.component.beanstalk.processors,9,449,449,898,8,99.77777777777777
camel,org.apache.camel.component.cm.exceptions,7,509,389,898,12,128.28571428571428
camel,org.apache.camel.component.aws.sqs.integration,23,755,143,898,7,39.04347826086956
camel,org.apache.camel.spring.boot.security,13,510,388,898,4,69.07692307692308
camel,org.apache.camel.component.ejb,30,630,267,897,10,29.9
camel,org.apache.camel.component.mapstruct,11,884,13,897,12,81.54545454545455
camel,org.apache.camel.http.base,36,706,190,896,8,24.88888888888889
camel,org.apache.camel.component.google.calendar.stream.springboot,17,448,448,896,2,52.705882352941174
camel,org.apache.camel.component.mqtt.springboot,27,447,447,894,6,33.111111111111114
camel,org.apache.camel.component.azure.eventhubs.operations,7,714,179,893,4,127.57142857142857
camel,org.apache.camel.dataformat.hessian,9,700,192,892,8,99.11111111111111
camel,org.apache.camel.component.pojo.timer,12,624,268,892,5,74.33333333333333
camel,test.java.org.apache.camel.itest,2,0,891,891,12,445.5
camel,org.apache.camel.component.jolt.springboot,29,444,444,888,6,30.620689655172413
camel,org.apache.camel.component.metrics.springboot,29,444,444,888,6,30.620689655172413
camel,org.apache.camel.test.perf,9,748,140,888,7,98.66666666666667
camel,org.apache.camel.component.freemarker.springboot,30,443,443,886,6,29.533333333333335
camel,org.apache.camel.component.grpc.server,19,711,175,886,8,46.63157894736842
camel,org.apache.camel.component.torchserve.it,2,885,0,885,6,442.5
camel,org.apache.camel.cloud,20,746,138,884,62,44.2
camel,org.apache.camel.component.jt400.springboot,29,442,442,884,6,30.482758620689655
camel,org.apache.camel.component.splunk.springboot,29,442,442,884,6,30.482758620689655
camel,org.apache.camel.component.google.pubsub.springboot,29,442,442,884,4,30.482758620689655
camel,org.apache.camel.component.velocity.springboot,29,442,442,884,6,30.482758620689655
camel,org.apache.camel.component.sql.stored.springboot,30,442,442,884,6,29.466666666666665
camel,org.apache.camel.component.apns.springboot,30,442,442,884,6,29.466666666666665
camel,org.apache.camel.component.atomix.client.map.springboot,14,514,370,884,4,63.142857142857146
camel,org.apache.camel.component.routebox.direct,16,442,442,884,3,55.25
camel,org.apache.camel.component.jdbc.springboot,30,442,442,884,6,29.466666666666665
camel,org.apache.camel.component.mustache.springboot,29,442,442,884,6,30.482758620689655
camel,org.apache.camel.component.gora.utils,12,467,416,883,2,73.58333333333333
camel,org.apache.camel.component.kubernetes.deprecated,14,868,15,883,18,63.07142857142857
camel,org.apache.camel.component.apns.util,16,590,293,883,8,55.1875
camel,org.apache.camel.utils.cassandra,24,597,285,882,4,36.75
camel,test.java.org.apache.camel.component.google.mail,2,0,882,882,9,441.0
camel,org.apache.camel.component.scp.springboot,31,440,440,880,6,28.387096774193548
camel,org.apache.camel.component.wordpress.api.service.spi,6,750,130,880,8,146.66666666666666
camel,io.fabric8.kubernetes.client,14,619,260,879,1,62.785714285714285
camel,org.apache.camel.component.jackson.avro,14,764,114,878,6,62.714285714285715
camel,org.apache.camel.support.task.budget,13,777,101,878,10,67.53846153846153
camel,org.apache.camel.component.openstack.cinder.producer,8,584,293,877,2,109.625
camel,org.apache.camel.component.mongodb.springboot,21,341,535,876,3,41.714285714285715
camel,org.apache.camel.jsr356,1,876,0,876,10,876.0
camel,test.java.org.apache.camel.component.azure.blob,1,0,876,876,7,876.0
camel,org.apache.camel.component.micrometer.json,15,705,170,875,2,58.333333333333336
camel,org.apache.camel.component.twitter.streaming,11,227,646,873,8,79.36363636363636
camel,org.apache.camel.component.ignite.messaging,29,772,101,873,8,30.103448275862068
camel,org.apache.camel.component.mongodb.converters,31,552,321,873,4,28.161290322580644
camel,test.java.org.apache.camel.component.resteasy.test.beans,2,0,871,871,13,435.5
camel,org.apache.camel.component.ignite.events,29,723,147,870,6,30.0
camel,org.apache.camel.component.seda.springboot,37,435,435,870,8,23.513513513513512
camel,org.apache.camel.component.stub.springboot,37,435,435,870,8,23.513513513513512
camel,test.java.org.apache.camel.itest.async,3,0,869,869,12,289.6666666666667
camel,org.apache.camel.component.ode,2,477,391,868,7,434.0
camel,org.apache.camel.component.vm.springboot,37,434,434,868,8,23.45945945945946
camel,org.apache.camel.support.processor.idempotent,26,519,348,867,8,33.34615384615385
camel,org.apache.camel.test.infra.common.services,33,720,145,865,13,26.21212121212121
camel,org.apache.camel.component.ignite.set,28,717,148,865,7,30.892857142857142
camel,test.java.org.apache.camel.component.gae.http,3,0,864,864,12,288.0
camel,org.apache.camel.component.file.consumer.adapters,11,573,291,864,9,78.54545454545455
camel,org.apache.camel.component.apns.factory,27,501,362,863,3,31.962962962962962
camel,org.apache.camel.model.validator,15,615,248,863,24,57.53333333333333
camel,org.apache.camel.component.kafka.integration.health,18,496,367,863,5,47.94444444444444
camel,org.apache.camel.component.slack.springboot,28,431,431,862,6,30.785714285714285
camel,test.java.org.apache.camel.component.elsql,2,0,860,860,9,430.0
camel,org.apache.camel.example.cafe.stuff,11,430,430,860,10,78.18181818181819
camel,test.java.org.apache.camel.component.vertx.kafka.operations,1,0,859,859,2,859.0
camel,org.apache.camel.component.djl.model.nlp,3,784,74,858,14,286.0
camel,org.apache.camel.component.hbase.filters,12,429,429,858,6,71.5
camel,org.apache.camel.test.junit5.params,10,560,296,856,10,85.6
camel,org.apache.camel.example.cxf.jaxrs,24,471,384,855,5,35.625
camel,org.apache.camel.dataformat.swift.mt,7,755,99,854,6,122.0
camel,org.apache.camel.component.jcache.processor.aggregate,24,721,132,853,5,35.541666666666664
camel,test.java.org.apache.camel.component.kubernetes.deprecated,3,0,853,853,18,284.3333333333333
camel,org.apache.camel.test.infra.solr.services,20,715,137,852,10,42.6
camel,org.apache.camel.component.google.mail.stream.springboot,14,426,426,852,2,60.857142857142854
camel,org.apache.camel.example.netty,6,426,426,852,7,142.0
camel,org.apache.camel.component.yql,13,562,289,851,5,65.46153846153847
camel,org.apache.camel.language.spel,34,726,123,849,11,24.970588235294116
camel,org.apache.camel.xml,26,682,167,849,2,32.65384615384615
camel,org.apache.camel.pgevent,22,667,181,848,7,38.54545454545455
camel,org.apache.camel.spring.boot.actuate.health,13,402,445,847,9,65.15384615384616
camel,test.java.org.apache.camel.component.ganglia,2,0,846,846,6,423.0
camel,org.apache.camel.component.kubernetes.cronjob,6,728,115,843,6,140.5
camel,org.apache.camel.core.osgi.impl,12,102,741,843,2,70.25
camel,org.apache.camel.component.netty4.codec,10,786,57,843,15,84.3
camel,org.apache.camel.dsl.jsh,8,451,390,841,5,105.125
camel,org.apache.camel.component.saga.springboot,12,420,420,840,4,70.0
camel,org.apache.camel.example.spring.boot.rest.jpa,12,463,377,840,8,70.0
camel,test.java.org.apache.camel.component.aws.secretsmanager.integration,7,0,838,838,7,119.71428571428571
camel,org.apache.camel.component.bean.validator.springboot,24,419,419,838,3,34.916666666666664
camel,org.apache.camel.component.azure.servicebus.client,12,490,347,837,3,69.75
camel,test.java.org.apache.camel.component.kubernetes.consumer.integration,1,0,837,837,5,837.0
camel,org.apache.camel.component.kafka.producer.support,15,661,175,836,6,55.733333333333334
camel,generated.java.org.apache.camel.main,6,0,836,836,9,139.33333333333334
camel,org.apache.camel.example.cxf.provider,18,417,417,834,5,46.333333333333336
camel,org.apache.camel.spring.bind,30,658,175,833,11,27.766666666666666
camel,org.apache.camel.component.kafka.embedded,32,681,152,833,5,26.03125
camel,org.apache.camel.component.hbase.processor.idempotent,24,486,345,831,3,34.625
camel,org.apache.camel.avro.generated,8,591,239,830,6,103.75
camel,org.apache.camel.component.corda.springboot,10,414,414,828,2,82.8
camel,org.apache.camel.component.salesforce.internal.dto,23,676,152,828,9,36.0
camel,org.apache.camel.component.zookeepermaster.springboot,18,413,413,826,2,45.888888888888886
camel,test.java.org.apache.camel.component.twitter.deprecated,2,0,826,826,14,413.0
camel,org.apache.camel.util.spring,11,718,105,823,14,74.81818181818181
camel,test.java.org.apache.camel.component.google.calendar,1,0,823,823,9,823.0
camel,org.apache.camel.component.microprofile.metrics.event.notifier.context,9,483,339,822,6,91.33333333333333
camel,org.apache.camel.component.infinispan.testcontainers,18,730,92,822,8,45.666666666666664
camel,org.apache.camel.component.infinispan.processor.idempotent,23,569,252,821,6,35.69565217391305
camel,org.apache.camel.component.box2.springboot,2,410,410,820,2,410.0
camel,org.apache.camel.component.directvm.springboot,35,409,409,818,8,23.37142857142857
camel,org.apache.camel.component.weaviate.it,6,532,285,817,2,136.16666666666666
camel,org.apache.camel.dsl.jbang.core.commands.kubernetes.traits.knative,13,761,56,817,3,62.84615384615385
camel,org.apache.camel.opentracing.concurrent,2,407,407,814,2,407.0
camel,org.apache.camel.component.jcache.springboot,24,407,407,814,3,33.916666666666664
camel,org.apache.camel.component.ehcache.processor.aggregate,23,708,104,812,4,35.30434782608695
camel,test.java.org.apache.camel.component.quickfixj.examples.trading,1,0,811,811,5,811.0
camel,test.java.org.apache.camel.component.micrometer,3,0,809,809,6,269.6666666666667
camel,org.apache.camel.component.mvel,48,577,232,809,6,16.854166666666668
camel,test.java.org.apache.camel.component.salesforce,4,0,809,809,6,202.25
camel,org.apache.camel.component.kafka.integration.batching,7,756,49,805,7,115.0
camel,org.apache.camel.dataformat.thrift,21,706,99,805,5,38.333333333333336
camel,org.apache.camel.karaf.commands.catalog,6,254,550,804,12,134.0
camel,org.apache.camel.component.atmos.springboot,24,401,401,802,3,33.416666666666664
camel,org.apache.camel.component.azure.servicebus.integration.operations,8,588,213,801,1,100.125
camel,org.apache.camel.processor.groovy,24,726,75,801,10,33.375
camel,org.apache.camel.component.aws.secretsmanager.vault,24,604,197,801,1,33.375
camel,org.apache.camel.component.caffeine.processor.aggregate,23,695,105,800,4,34.78260869565217
camel,org.apache.camel.dataformat.avro.example,5,690,109,799,2,159.8
camel,org.apache.camel.dsl.jbang.core.commands.plugin,10,742,57,799,8,79.9
camel,org.apache.camel.component.cdi,19,518,281,799,5,42.05263157894737
camel,org.apache.camel.component.xj.springboot,6,399,399,798,2,133.0
camel,org.apache.camel.spring.boot.issues,14,601,196,797,5,56.92857142857143
camel,org.apache.camel.language.xquery.springboot,23,398,398,796,6,34.608695652173914
camel,org.apache.camel.test.infra.hdfs.v2.services,13,643,151,794,10,61.07692307692308
camel,org.apache.camel.component.ibatis.springboot,12,408,386,794,4,66.16666666666667
camel,org.apache.camel.impl.cluster,41,408,385,793,31,19.341463414634145
camel,org.apache.camel.component.aws.msk.springboot,10,395,395,790,2,79.0
camel,org.apache.camel.parser.xml,24,693,93,786,17,32.75
camel,test.java.org.apache.camel.component.facebook,1,0,784,784,6,784.0
camel,org.apache.camel.dataformat.springboot,3,12,772,784,8,261.3333333333333
camel,org.apache.camel.component.jgroups.raft.cluster,22,689,94,783,7,35.59090909090909
camel,org.foo.mention.springboot,11,391,391,782,3,71.0909090909091
camel,org.apache.camel.component.aws.translate.springboot,7,390,390,780,2,111.42857142857143
camel,test.java.org.apache.camel.guice,1,0,779,779,13,779.0
camel,org.apache.camel.jta,18,360,419,779,5,43.27777777777778
camel,org.apache.camel.component.sjms.it,19,595,183,778,5,40.94736842105263
camel,test.java.org.apache.camel.component.cmis,1,0,777,777,4,777.0
camel,org.apache.camel.component.pdf.text,16,710,66,776,13,48.5
camel,org.apache.camel.component.ignite.compute.springboot,18,388,388,776,2,43.111111111111114
camel,org.apache.camel.component.aws2.bedrock.runtime,19,717,59,776,10,40.8421052631579
camel,org.apache.camel.metrics.timer,6,690,84,774,10,129.0
camel,org.apache.camel.component.ignite.idgen,27,669,104,773,7,28.62962962962963
camel,org.apache.camel.component.aws2.kms.localstack,21,670,103,773,15,36.80952380952381
camel,org.apache.camel.component.aws.xray.json,12,622,151,773,7,64.41666666666667
camel,org.apache.camel.converter.soap,2,761,12,773,9,386.5
camel,org.apache.camel.component.nats.springboot,24,386,386,772,3,32.166666666666664
camel,org.apache.camel.component.google.bigquery.sql.springboot,16,386,386,772,2,48.25
camel,generated.java.org.apache.camel.component.aws.s3,1,0,770,770,3,770.0
camel,org.apache.camel.language.jxpath.springboot,20,385,385,770,6,38.5
camel,org.apache.camel.component.rest.openapi.validator,5,541,229,770,6,154.0
camel,org.apache.camel.component.splunk.event,12,641,129,770,1,64.16666666666667
camel,org.apache.camel.spring.routebuilder,29,722,47,769,11,26.517241379310345
camel,test.java.org.apache.camel.component.minio.integration.remoteTests,1,0,769,769,7,769.0
camel,org.apache.camel.component.ignite.messaging.springboot,18,384,384,768,2,42.666666666666664
camel,org.apache.camel.component.ignite.cache.springboot,19,383,383,766,2,40.31578947368421
camel,org.apache.camel.component.ignite.idgen.springboot,19,383,383,766,2,40.31578947368421
camel,org.apache.camel.component.ignite.queue.springboot,19,383,383,766,2,40.31578947368421
camel,org.apache.camel.component.redis.processor.aggregate,8,627,139,766,3,95.75
camel,org.apache.camel.test.infra.couchbase.services,22,645,121,766,7,34.81818181818182
camel,org.apache.camel.component.ignite.events.springboot,18,382,382,764,2,42.44444444444444
camel,generated.java.org.apache.camel.component.aws.sqs,1,0,764,764,3,764.0
camel,test.java.org.apache.camel.component.google.sheets,2,0,763,763,6,381.5
camel,org.apache.camel.component.ignite.set.springboot,18,381,381,762,2,42.333333333333336
camel,org.apache.camel.component.twilio.springboot,13,381,381,762,2,58.61538461538461
camel,org.apache.camel.dataformat.deflater.springboot,2,381,381,762,4,381.0
camel,org.apache.camel.reifier.loadbalancer,23,602,160,762,26,33.130434782608695
camel,org.apache.camel.catalog.karaf,20,435,326,761,6,38.05
camel,test.java.org.apache.camel.component.atomix.client.map,1,0,759,759,4,759.0
camel,dataformat.springboot,2,379,379,758,4,379.0
camel,test.java.org.apache.camel.component.jbi,2,0,758,758,9,379.0
camel,org.apache.camel.component.ironmq.integrationtest,19,642,116,758,12,39.89473684210526
camel,org.apache.camel.component.weather.springboot,23,378,378,756,3,32.869565217391305
camel,org.apache.camel.testng.patterns,13,728,27,755,10,58.07692307692308
camel,org.apache.camel.component.ribbon.springboot.cloud,9,560,195,755,6,83.88888888888889
camel,org.apache.camel.component.spring.ws.springboot,23,377,377,754,3,32.78260869565217
camel,test.java.org.apache.camel.dataformat.any23,2,0,754,754,12,377.0
camel,org.apache.camel.component.kubernetes.cluster,21,516,237,753,5,35.857142857142854
camel,org.apache.camel.component.pulsar.utils.consumers,26,659,94,753,10,28.96153846153846
camel,org.apache.camel.component.crypto.cms.exception,5,376,376,752,10,150.4
camel,test.java.org.apache.camel.component.sjms.batch,1,0,752,752,4,752.0
camel,org.apache.camel.openapi.model,4,746,6,752,16,188.0
camel,org.apache.camel.example.spring.boot,12,399,351,750,4,62.5
camel,org.apache.camel.component.irc.springboot,23,373,373,746,3,32.43478260869565
camel,org.apache.camel.component.schematron.processor,29,597,148,745,6,25.689655172413794
camel,org.apache.camel.component.hazelcast.atomicnumber.springboot,16,372,372,744,2,46.5
camel,org.apache.camel.component.uface,13,476,268,744,12,57.23076923076923
camel,org.apache.camel.component.google.bigquery.springboot,14,371,371,742,2,53.0
camel,org.apache.camel.component.ahc.helper,17,371,371,742,2,43.64705882352941
camel,test.java.org.apache.camel.component.spring.ws,2,0,742,742,8,371.0
camel,org.apache.camel.component.salesforce.api.dto.bulkv2,3,741,0,741,13,247.0
camel,org.apache.camel.yaml,20,596,145,741,1,37.05
camel,org.apache.camel.component.hazelcast.replicatedmap.springboot,16,370,370,740,2,46.25
camel,org.apache.camel.component.hazelcast.ringbuffer.springboot,16,370,370,740,2,46.25
camel,org.apache.camel.component.hazelcast.instance.springboot,16,370,370,740,2,46.25
camel,org.apache.camel.component.ical,29,583,157,740,5,25.517241379310345
camel,org.apache.camel.component.hazelcast.multimap.springboot,16,370,370,740,2,46.25
camel,org.apache.camel.component.direct.springboot,33,368,368,736,8,22.303030303030305
camel,org.apache.camel.dsl.jbang.core.commands.config,8,673,63,736,10,92.0
camel,org.apache.camel.dataformat.soap.name,28,484,251,735,8,26.25
camel,org.apache.camel.component.smooks.converter,6,626,109,735,9,122.5
camel,org.apache.camel.component.pubnub.example,21,580,155,735,8,35.0
camel,org.apache.camel.component.elasticsearch5.converter,5,472,263,735,2,147.0
camel,org.apache.camel.test.infra.nats.services,38,565,169,734,10,19.31578947368421
camel,org.apache.camel.component.file.remote.services,8,602,132,734,3,91.75
camel,org.apache.camel.component.atomix.client.messaging.springboot,12,367,367,734,2,61.166666666666664
camel,org.apache.camel.component.rabbitmq.qpid,11,490,241,731,9,66.45454545454545
camel,org.apache.camel.itest.jms2,12,601,129,730,6,60.833333333333336
camel,org.apache.camel.component.spring.integration.springboot,23,365,365,730,3,31.73913043478261
camel,org.apache.camel.component.wordpress.springboot,13,364,364,728,2,56.0
camel,org.apache.camel.itest.security,31,578,150,728,7,23.483870967741936
camel,org.apache.camel.test.infra.aws2.clients,22,594,134,728,4,33.09090909090909
camel,test.java.org.apache.camel.language,5,0,728,728,6,145.6
camel,generated.java.org.apache.camel.model,2,0,728,728,4,364.0
camel,test.java.org.apache.camel.component.sjms.tx,3,0,728,728,10,242.66666666666666
camel,test.java.org.apache.camel.component.aws.cw,2,0,728,728,7,364.0
camel,test.java.org.apache.camel.component.gae.auth,2,0,727,727,11,363.5
camel,org.apache.camel.component.caffeine,20,631,96,727,7,36.35
camel,test.java.org.apache.camel.component.ahc.ws,1,0,726,726,8,726.0
camel,test.java.org.apache.camel.component.file.remote,7,0,725,725,10,103.57142857142857
camel,org.apache.camel.component.aws2.sns.integration,23,624,101,725,13,31.52173913043478
camel,org.apache.camel.component.xmpp.springboot,24,362,362,724,3,30.166666666666668
camel,org.apache.camel.language.groovy.springboot,23,362,362,724,6,31.47826086956522
camel,org.apache.camel.test.infra.fhir.services,25,536,187,723,8,28.92
camel,org.apache.camel.dataformat.bindy.model.csv,7,457,266,723,2,103.28571428571429
camel,org.apache.camel.main.http,14,132,590,722,1,51.57142857142857
camel,org.apache.camel.language.spel.springboot,22,360,360,720,6,32.72727272727273
camel,org.apache.camel.language.mvel.springboot,22,360,360,720,6,32.72727272727273
camel,org.apache.camel.component.openstack.keystone.springboot,20,360,360,720,3,36.0
camel,org.apache.camel.language.ognl.springboot,22,360,360,720,6,32.72727272727273
camel,test.java.org.apache.camel.component.jms.issues,8,0,718,718,9,89.75
camel,org.apache.camel.component.iec60870.server.springboot,11,359,359,718,2,65.27272727272727
camel,org.apache.camel.component.hazelcast.queue.springboot,15,359,359,718,2,47.86666666666667
camel,org.apache.camel.component.google.sheets.springboot,10,359,359,718,2,71.8
camel,org.apache.camel.component.hazelcast.topic.springboot,15,359,359,718,2,47.86666666666667
camel,org.apache.camel.component.hazelcast.seda.springboot,15,359,359,718,2,47.86666666666667
camel,org.apache.camel.component.sip.springboot,28,359,359,718,3,25.642857142857142
camel,org.apache.camel.component.hazelcast.list.springboot,15,359,359,718,2,47.86666666666667
camel,test.java.org.apache.camel.component.twitter,4,0,717,717,13,179.25
camel,org.apache.camel.component.hazelcast.set.springboot,16,358,358,716,2,44.75
camel,org.apache.camel.test.infra.mosquitto.services,15,514,201,715,7,47.666666666666664
camel,generated.java.org.apache.camel.component.google.calendar.internal,1,0,715,715,10,715.0
camel,org.apache.camel.component.hazelcast.map.springboot,15,357,357,714,2,47.6
camel,org.apache.camel.component.bonita.springboot,24,357,357,714,3,29.75
camel,org.apache.camel.component.aws.xray.decorators.messaging,8,549,165,714,16,89.25
camel,org.apache.camel.component.tika.springboot,22,357,357,714,2,32.45454545454545
camel,org.apache.camel.language.juel.springboot,20,356,356,712,6,35.6
camel,org.apache.camel.language.sql.springboot,20,356,356,712,6,35.6
camel,org.apache.camel.component.atomix.client.multimap.springboot,12,356,356,712,2,59.333333333333336
camel,org.apache.camel.component.dropbox.springboot,23,356,356,712,3,30.956521739130434
camel,org.apache.camel.component.stream.springboot,24,355,355,710,3,29.583333333333332
camel,org.apache.camel.component.stringtemplate.springboot,22,355,355,710,3,32.27272727272727
camel,org.apache.camel.component.pgevent.springboot,23,355,355,710,3,30.869565217391305
camel,org.apache.camel.model.tokenizer,6,630,79,709,7,118.16666666666667
camel,org.apache.camel.coap.springboot,23,354,354,708,3,30.782608695652176
camel,org.apache.camel.component.timer.springboot,23,354,354,708,5,30.782608695652176
camel,org.apache.camel.component.mock.springboot,23,354,354,708,5,30.782608695652176
camel,generated.java.org.apache.camel.component.aws.kinesis,2,0,708,708,4,354.0
camel,org.apache.camel.component.hipchat.springboot,22,354,354,708,3,32.18181818181818
camel,org.apache.camel.component.ejb.springboot,10,364,344,708,4,70.8
camel,org.apache.camel.component.ref.springboot,23,354,354,708,5,30.782608695652176
camel,org.apache.camel.component.pdf.springboot,23,354,354,708,3,30.782608695652176
camel,com.braintreegateway,7,683,24,707,4,101.0
camel,org.apache.camel.component.jbpm.springboot,22,353,353,706,3,32.09090909090909
camel,org.apache.camel.component.fop.springboot,22,353,353,706,3,32.09090909090909
camel,org.apache.camel.component.dozer.springboot,22,353,353,706,3,32.09090909090909
camel,org.apache.camel.component.couchdb.springboot,22,353,353,706,3,32.09090909090909
camel,org.apache.camel.component.gora.springboot,22,353,353,706,3,32.09090909090909
camel,org.apache.camel.component.ldap.springboot,22,353,353,706,3,32.09090909090909
camel,org.apache.camel.component.asterisk.springboot,23,353,353,706,3,30.695652173913043
camel,org.apache.camel.component.jcr.springboot,22,353,353,706,3,32.09090909090909
camel,org.apache.camel.component.influxdb.springboot,23,353,353,706,3,30.695652173913043
camel,org.apache.camel.component.ironmq.springboot,22,353,353,706,3,32.09090909090909
camel,org.apache.camel.component.stax.springboot,22,353,353,706,3,32.09090909090909
camel,org.apache.camel.component.cm.springboot,23,353,353,706,3,30.695652173913043
camel,org.apache.camel.component.printer.springboot,22,353,353,706,3,32.09090909090909
camel,org.apache.camel.component.optaplanner.springboot,23,353,353,706,3,30.695652173913043
camel,org.apache.camel.component.geocoder.springboot,23,353,353,706,3,30.695652173913043
camel,org.apache.camel.component.snmp.springboot,22,353,353,706,3,32.09090909090909
camel,org.apache.camel.component.drill.springboot,22,353,353,706,3,32.09090909090909
camel,org.apache.camel.component.language.springboot,23,353,353,706,5,30.695652173913043
camel,org.apache.camel.component.bonita.api.model,5,499,206,705,4,141.0
camel,org.apache.camel.component.openstack.neutron.springboot,19,352,352,704,3,37.05263157894737
camel,org.apache.camel.component.mail.stream.springboot,3,352,352,704,2,234.66666666666666
camel,org.apache.camel.component.chunk.springboot,22,352,352,704,3,32.0
camel,org.apache.camel.component.jmx.springboot,22,352,352,704,3,32.0
camel,org.apache.camel.component.github.springboot,22,352,352,704,3,32.0
camel,org.apache.camel.component.dns.springboot,22,352,352,704,3,32.0
camel,org.apache.camel.component.rss.springboot,22,352,352,704,3,32.0
camel,org.apache.camel.component.git.springboot,22,352,352,704,3,32.0
camel,org.apache.camel.component.redis.springboot,22,352,352,704,3,32.0
camel,org.apache.camel.component.exec.springboot,22,352,352,704,3,32.0
camel,org.apache.camel.component.sap.netweaver.springboot,22,352,352,704,3,32.0
camel,org.apache.camel.component.springldap.springboot,22,352,352,704,3,32.0
camel,org.apache.camel.component.cassandra.springboot,22,352,352,704,3,32.0
camel,org.apache.camel.test.infra.aws.services,7,556,148,704,7,100.57142857142857
camel,org.apache.camel.component.validator.jing.springboot,22,352,352,704,3,32.0
camel,org.apache.camel.component.mvel.springboot,22,352,352,704,3,32.0
camel,org.apache.camel.component.atom.springboot,22,352,352,704,3,32.0
camel,org.apache.camel.component.flatpack.springboot,22,352,352,704,3,32.0
camel,generated.java.org.apache.camel.component.google.mail.internal,1,0,704,704,9,704.0
camel,org.apache.camel.component.log.springboot,29,351,351,702,8,24.20689655172414
camel,org.apache.camel.component.openstack.swift.springboot,18,351,351,702,3,39.0
camel,org.apache.camel.component.schematron.springboot,22,351,351,702,3,31.90909090909091
camel,org.apache.camel.builder.sql,25,407,295,702,7,28.08
camel,org.apache.camel.component.openstack.cinder.springboot,19,351,351,702,3,36.94736842105263
camel,org.apache.camel.component.openstack.glance.springboot,19,351,351,702,3,36.94736842105263
camel,org.apache.camel.component.openstack.nova.springboot,19,351,351,702,3,36.94736842105263
camel,test.java.org.apache.camel.testng.patterns,2,0,701,701,10,350.5
camel,org.apache.camel.component.couchbase.springboot,18,350,350,700,3,38.888888888888886
camel,org.apache.camel.test.infra.mongodb.services,22,512,188,700,7,31.818181818181817
camel,org.apache.camel.test.infra.cli.services,14,634,64,698,4,49.857142857142854
camel,org.apache.camel.component.cmis.springboot,23,349,349,698,4,30.347826086956523
camel,org.apache.camel.component.consul.health,10,349,349,698,2,69.8
camel,org.apache.camel.component.dns.processor.remote,5,389,309,698,7,139.6
camel,test.java.org.apache.camel.processor.aggregator,6,0,697,697,8,116.16666666666667
camel,test.java.org.apache.camel.rx,1,0,695,695,13,695.0
camel,org.apache.camel.dataformat.xmlrpc,10,421,274,695,4,69.5
camel,org.apache.camel.component.twitter.directmessage.springboot,10,347,347,694,2,69.4
camel,org.apache.camel.itest.osgi.cxf.blueprint,19,565,127,692,3,36.421052631578945
camel,org.apache.camel.dataformat.bindy.model.fix.simple,7,490,201,691,3,98.71428571428571
camel,org.apache.camel.component.sql.stored.template.ast,17,455,235,690,8,40.588235294117645
camel,test.java.org.apache.camel.example.reportincident,7,0,690,690,7,98.57142857142857
camel,org.apache.camel.test.infra.infinispan.services,55,546,143,689,7,12.527272727272727
camel,org.apache.camel.component.grpc.client,18,601,88,689,8,38.27777777777778
camel,org.apache.camel.component.yql.configuration,7,411,278,689,3,98.42857142857143
camel,org.apache.camel.component.azure.cosmosdb.integration.operations,5,680,8,688,3,137.6
camel,org.apache.camel.example.server,18,213,475,688,9,38.22222222222222
camel,org.apache.camel.component.kubernetes.springboot.cloud,10,439,248,687,5,68.7
camel,org.apache.camel.component.webhook.springboot,7,343,343,686,2,98.0
camel,org.apache.camel.component.atomix.client.value.springboot,12,343,343,686,2,57.166666666666664
camel,org.apache.camel.component.milo.testing,10,531,154,685,5,68.5
camel,test.java.org.apache.camel.component.aws.sqs.integration,2,0,685,685,7,342.5
camel,test.java.org.apache.camel.component.yammer,2,0,685,685,12,342.5
camel,test.java.org.apache.camel.component.google.storage.localstorage,1,0,685,685,2,685.0
camel,test.java.org.apache.camel.component.atomix.cluster,1,0,684,684,9,684.0
camel,org.apache.camel.component.stitch.operations,2,680,3,683,3,341.5
camel,org.apache.camel.util.xml,27,598,85,683,20,25.296296296296298
camel,org.apache.camel.component.rest.openapi.springboot,2,341,341,682,2,341.0
camel,org.apache.camel.spring.boot.model,8,341,341,682,3,85.25
camel,org.apache.camel.itest.osgi.zookeeper,15,608,74,682,2,45.46666666666667
camel,org.apache.camel.pollconsumer.quartz2,27,580,102,682,7,25.25925925925926
camel,org.apache.camel.test.cxf.blueprint,20,647,35,682,7,34.1
camel,org.apache.camel.support.resume,20,546,136,682,7,34.1
camel,org.apache.camel.spring.cloud.zookeeper,7,466,215,681,7,97.28571428571429
camel,org.apache.camel.dsl.jbang.it.support,24,653,28,681,4,28.375
camel,test.java.org.apache.camel.component.cxf.jaxrs.testbean,2,0,680,680,9,340.0
camel,org.apache.camel.test.blueprint.component.rest,36,562,117,679,10,18.86111111111111
camel,org.apache.camel.maven.packaging.endpoint,8,667,11,678,22,84.75
camel,org.apache.camel.component.telegram.springboot,24,339,339,678,4,28.25
camel,org.apache.camel.examples,27,567,110,677,8,25.074074074074073
camel,org.apache.camel.itest.osgi.jaxb,19,518,158,676,5,35.578947368421055
camel,test.java.org.apache.camel.component.ribbon.cloud,1,0,676,676,10,676.0
camel,org.apache.camel.test.infra.elasticsearch.services,23,548,127,675,7,29.347826086956523
camel,test.java.org.apache.camel.itest.http,6,0,674,674,8,112.33333333333333
camel,org.apache.camel.component.twitter.timeline.springboot,9,337,337,674,2,74.88888888888889
camel,org.apache.camel.itest.osgi.jpa,33,501,173,674,4,20.424242424242426
camel,org.apache.camel.groovy.xml,3,652,21,673,3,224.33333333333334
camel,org.apache.camel.component.twitter.search.springboot,9,336,336,672,2,74.66666666666667
camel,org.apache.camel.component.grpc.springboot,18,342,330,672,2,37.333333333333336
camel,org.apache.camel.example.kafka.avro,3,335,335,670,7,223.33333333333334
camel,org.apache.camel.component.dfdl,3,638,32,670,9,223.33333333333334
camel,org.apache.camel.processor.converter,11,560,106,666,4,60.54545454545455
camel,org.apache.camel.dsl.js,16,403,263,666,3,41.625
camel,org.apache.camel.dataformat.bindy.fixed.headerfooter,14,573,92,665,4,47.5
camel,org.apache.camel.component.wasm,6,634,30,664,9,110.66666666666667
camel,test.java.org.apache.camel.itest.doc,2,0,664,664,14,332.0
camel,org.apache.camel.component.aws.ec2.integration,11,569,94,663,2,60.27272727272727
camel,org.apache.camel.component.atomix.client.queue.springboot,12,331,331,662,2,55.166666666666664
camel,org.apache.camel.component.dynamicrouter.filter,2,614,46,660,6,330.0
camel,org.apache.camel.component.xslt.saxon.springboot,3,330,330,660,2,220.0
camel,org.apache.camel.maven.sync.properties,27,454,205,659,1,24.40740740740741
camel,org.apache.camel.api.management,26,448,211,659,22,25.346153846153847
camel,org.apache.camel.guice.jsr250,4,329,329,658,5,164.5
camel,org.apache.camel.component.extension.verifier,26,342,315,657,25,25.26923076923077
camel,org.apache.camel.spring.cloud.consul,8,418,239,657,7,82.125
camel,test.java.org.apache.camel.language.datasonnet,1,0,657,657,6,657.0
camel,org.apache.camel.component.dhis2.internal,12,571,85,656,9,54.666666666666664
camel,org.apache.camel.dataformat.bindy.model.simple.oneclass,12,411,243,654,1,54.5
camel,org.apache.camel.component.azure.key.vault.integration.operations,14,588,63,651,3,46.5
camel,org.apache.camel.component.cbor.springboot,4,325,325,650,2,162.5
camel,org.apache.camel.component.dozer.example.abc,7,560,90,650,2,92.85714285714286
camel,test.java.org.apache.camel.component.microprofile.metrics.route.policy,2,0,650,650,6,325.0
camel,org.apache.camel.component.kafka.integration.pause,9,526,124,650,2,72.22222222222223
camel,org.apache.camel.component.hazelcast.springboot.customizer,5,416,234,650,3,130.0
camel,org.apache.camel.component.azure.cosmosdb.integration,4,640,9,649,3,162.25
camel,test.java.org.apache.camel.component.azure.storage.datalake.integration,1,0,647,647,5,647.0
camel,org.apache.camel.component.aws2.sqs.localstack,13,572,75,647,7,49.76923076923077
camel,test.java.org.apache.camel.maven.component.vertx.kafka.config,1,0,647,647,4,647.0
camel,test.java.org.apache.camel.spring.boot.cloud,1,0,646,646,6,646.0
camel,org.apache.camel.example.springboot,10,323,323,646,5,64.6
camel,org.apache.camel.itest.restlet.example,9,630,15,645,10,71.66666666666667
camel,org.apache.camel.component.reactive.streams.util,21,526,119,645,7,30.714285714285715
camel,test.java.org.apache.camel.component.azure.eventhubs,1,0,644,644,6,644.0
camel,test.java.org.apache.camel.spring,10,0,642,642,12,64.2
camel,org.apache.camel.component.cxf.phase,3,376,266,642,6,214.0
camel,test.java.org.apache.camel.component.johnzon,1,0,641,641,9,641.0
camel,test.java.org.apache.camel.test.junit4,1,0,641,641,16,641.0
camel,test.java.org.apache.camel.component.nagios,3,0,641,641,6,213.66666666666666
camel,test.java.sample.camel,2,0,640,640,13,320.0
camel,org.apache.camel.component.pubnub.springboot,18,320,320,640,2,35.55555555555556
camel,org.apache.camel.dataformat.rss,40,506,134,640,7,16.0
camel,test.java.org.apache.camel.component.infinispan.testcontainers,1,0,638,638,8,638.0
camel,org.apache.camel.component.digitalocean.integration,18,336,302,638,3,35.44444444444444
camel,org.apache.camel.example.gauth,6,319,319,638,4,106.33333333333333
camel,org.apache.camel.main.xml.blueprint,14,590,47,637,1,45.5
camel,test.java.org.apache.camel.itest.jms,3,0,637,637,6,212.33333333333334
camel,test.java.org.apache.camel.component.aws2.s3.integration,1,0,637,637,6,637.0
camel,org.apache.camel.spring.builder,5,43,594,637,7,127.4
camel,test.java.org.apache.camel.component.dozer,1,0,636,636,9,636.0
camel,org.apache.camel.component.solr.springboot,21,318,318,636,3,30.285714285714285
camel,org.apache.camel.component.boon,20,448,187,635,4,31.75
camel,org.apache.camel.component.jooq.springboot,10,317,317,634,2,63.4
camel,org.apache.camel.component.digitalocean.springboot,16,317,317,634,2,39.625
camel,org.apache.camel.component.hdfs2.springboot,32,413,220,633,8,19.78125
camel,org.apache.camel.component.consul.cluster,45,349,283,632,12,14.044444444444444
camel,org.apache.camel.component.atmos.core,11,316,316,632,1,57.45454545454545
camel,org.apache.camel.component.microprofile.metrics.event.notifier,10,315,315,630,6,63.0
camel,org.apache.camel.component.mongodb.gridfs.springboot,18,275,355,630,2,35.0
camel,org.apache.camel.component.zookeeper.springboot.cloud,5,399,231,630,3,126.0
camel,org.apache.camel.component.spring.batch.support,18,555,74,629,8,34.94444444444444
camel,test.resources.routes,9,497,131,628,18,69.77777777777777
camel,org.apache.camel.example.kafka,11,313,313,626,3,56.90909090909091
camel,org.apache.camel.test.testcontainers.spring.junit5,9,375,251,626,4,69.55555555555556
camel,test.java.org.apache.camel.commands,3,0,625,625,6,208.33333333333334
camel,org.apache.camel.component.urlrewrite,10,353,271,624,3,62.4
camel,org.foo.connector.springboot,9,312,312,624,3,69.33333333333333
camel,org.apache.camel.example.cdi.test,13,512,112,624,8,48.0
camel,org.apache.camel.component.twitter.consumer.timeline,9,425,198,623,6,69.22222222222223
camel,org.apache.camel.component.hazelcast.policy,16,503,120,623,2,38.9375
camel,test.java.org.apache.camel.impl.lw,1,0,621,621,4,621.0
camel,org.apache.camel.metrics.meter,7,550,71,621,10,88.71428571428571
camel,org.apache.camel.test.infra.smb.services,13,498,123,621,9,47.76923076923077
camel,test.java.org.apache.camel.component.quickfixj.examples,1,0,620,620,5,620.0
camel,org.apache.camel.example.google.pubsub,6,310,310,620,4,103.33333333333333
camel,org.apache.camel.component.soroushbot.service,9,377,243,620,3,68.88888888888889
camel,org.apache.camel.test.infra.postgres.services,16,471,148,619,7,38.6875
camel,org.apache.camel.example.jmstofile,17,284,335,619,5,36.411764705882355
camel,org.apache.camel.dataformat.deflater,25,395,223,618,10,24.72
camel,org.apache.camel.bam.rules,25,115,501,616,6,24.64
camel,org.apache.camel.component.fastjson,27,557,59,616,5,22.814814814814813
camel,test.java.org.apache.camel.language.jxpath,2,0,615,615,11,307.5
camel,test.java.org.apache.camel.itest.restlet.example,2,0,615,615,10,307.5
camel,org.apache.camel.component.smooks.routing,1,615,0,615,5,615.0
camel,test.java.org.apache.camel.component.weka,1,0,615,615,4,615.0
camel,org.apache.camel.opentracing.propagation,10,446,168,614,6,61.4
camel,org.apache.camel.component.wsservlet,5,596,17,613,5,122.6
camel,org.apache.camel.component.iec60870.client.springboot,12,306,306,612,2,51.0
camel,org.apache.camel.component.spring.integration.adapter.config,16,306,306,612,5,38.25
camel,test.java.org.apache.camel.test.cxf.blueprint,1,0,612,612,7,612.0
camel,test.java.org.apache.camel.converter,4,0,612,612,4,153.0
camel,org.apache.camel.component.beanclass,54,380,230,610,9,11.296296296296296
camel,org.apache.camel.component.chronicle.engine.springboot,18,305,305,610,3,33.888888888888886
camel,org.apache.camel.component.jackson.protobuf,12,521,88,609,5,50.75
camel,org.foo.find.springboot,8,172,437,609,4,76.125
camel,main.resources.archetype-resources.src.main.java.incident,2,304,304,608,7,304.0
camel,test.java.org.apache.camel.test.perf,1,0,608,608,7,608.0
camel,org.apache.camel.component.context.springboot,17,304,304,608,3,35.76470588235294
camel,org.apache.camel.component.arangodb.integration,14,364,243,607,15,43.357142857142854
camel,org.apache.camel.component.hbase.model,13,303,303,606,3,46.61538461538461
camel,org.apache.camel.component.rmi.springboot,19,303,303,606,3,31.894736842105264
camel,org.apache.camel.component.aws.secretsmanager.localstack,12,598,8,606,10,50.5
camel,org.apache.camel.guice.jndi,2,303,303,606,3,303.0
camel,org.apache.camel.component.file.watch.springboot,5,303,303,606,2,121.2
camel,test.java.org.apache.camel.component.sjms.support,3,0,605,605,5,201.66666666666666
camel,org.apache.camel.component.binding.springboot,18,302,302,604,3,33.55555555555556
camel,org.apache.camel.throttling,27,437,167,604,12,22.37037037037037
camel,test.java.org.apache.camel.component.aws.firehose,2,0,604,604,8,302.0
camel,org.apache.camel.component.aws2.sqs.client.impl,12,569,34,603,6,50.25
camel,org.apache.camel.component.twitter.streaming.springboot,7,301,301,602,2,86.0
camel,org.apache.camel.support.cluster,10,434,167,601,9,60.1
camel,org.apache.camel.component.xmlrpc.springboot,17,300,300,600,3,35.294117647058826
camel,org.apache.camel.component.kubernetes.springboot,18,300,300,600,3,33.333333333333336
camel,org.apache.camel.component.krati.springboot,17,300,300,600,3,35.294117647058826
camel,org.apache.camel.metrics.histogram,6,520,80,600,10,100.0
camel,org.apache.camel.component.routebox.springboot,17,300,300,600,3,35.294117647058826
camel,test.java.org.apache.camel.spring.boot.util,1,0,599,599,8,599.0
camel,org.apache.camel.component.javaspace.springboot,17,299,299,598,3,35.1764705882353
camel,org.apache.camel.component.aws2.lambda.localstack,11,547,50,597,6,54.27272727272727
camel,org.apache.camel.component.mongodb.processor.idempotent,13,393,204,597,3,45.92307692307692
camel,org.apache.camel.web.model,20,181,415,596,5,29.8
camel,org.apache.camel.tests.component,11,298,298,596,2,54.18181818181818
camel,org.apache.camel.example.widget,7,298,298,596,9,85.14285714285714
camel,org.apache.camel.component.azure.storage.queue.client,7,396,200,596,6,85.14285714285714
camel,org.apache.camel.test.testcontainers.spring,18,329,266,595,4,33.05555555555556
camel,org.apache.camel.component.reactive.streams.support,23,514,81,595,5,25.869565217391305
camel,org.apache.camel.component.jira.mocks,5,568,27,595,5,119.0
camel,org.apache.camel.component.langchain4j.tokenizer,3,588,6,594,12,198.0
camel,org.apache.camel.dsl.support,22,508,86,594,6,27.0
camel,org.apache.camel.pojo,7,529,64,593,12,84.71428571428571
camel,org.apache.camel.component.servlet.osgi,16,256,337,593,1,37.0625
camel,org.apache.camel.test.infra.cassandra.services,26,456,137,593,7,22.807692307692307
camel,org.apache.camel.itest.springboot.arquillian.container,5,586,6,592,4,118.4
camel,org.apache.camel.cdi.rule,12,491,100,591,5,49.25
camel,test.java.org.apache.camel.component.cxf,7,0,590,590,9,84.28571428571429
camel,test.java.org.apache.camel.component.kafka.integration,3,0,589,589,3,196.33333333333334
camel,org.apache.camel.test.junit5.util,21,561,28,589,5,28.047619047619047
camel,test.java.org.apache.camel.component.servletlistener,1,0,589,589,12,589.0
camel,org.apache.camel.example.as2,4,294,294,588,4,147.0
camel,org.apache.camel.component.couchdb.consumer,11,293,293,586,8,53.27272727272727
camel,org.apache.camel.groovy.converter,10,293,293,586,4,58.6
camel,generated.java.org.apache.camel.dsl.yaml.deserializers,1,0,585,585,2,585.0
camel,org.apache.camel.test.infra.rabbitmq.services,19,493,91,584,8,30.736842105263158
camel,org.apache.camel.component.azure.eventhubs.client,8,400,183,583,2,72.875
camel,org.apache.camel.dsl.jbang,2,583,0,583,5,291.5
camel,test.java.org.apache.camel.util,5,0,583,583,5,116.6
camel,org.apache.camel.dataformat.bindy.csv2,15,498,85,583,6,38.86666666666667
camel,test.java.org.apache.camel.itest.jetty,3,0,582,582,9,194.0
camel,org.apache.camel.component.swagger,10,425,157,582,6,58.2
camel,org.apache.camel.component.qdrant.it,7,536,46,582,6,83.14285714285714
camel,test.java.org.apache.camel.component.google.bigquery.integration,1,0,581,581,5,581.0
camel,test.java.org.apache.camel.component.rmi,1,0,581,581,10,581.0
camel,test.java.org.apache.camel.itest.springboot.arquillian.container,1,0,580,580,4,580.0
camel,org.apache.camel.component.pulsar.springboot,8,290,290,580,2,72.5
camel,org.apache.camel.component.aws2.iam.localstack,12,523,56,579,7,48.25
camel,org.apache.camel.test.infra.rocketmq.services,18,462,117,579,10,32.166666666666664
camel,org.apache.camel.component.wordpress.api.service.impl.ignored,9,524,54,578,7,64.22222222222223
camel,org.apache.camel.example.cdi.metrics,14,181,397,578,8,41.285714285714285
camel,org.apache.camel.component.pqc.crypto.kem,5,576,1,577,10,115.4
camel,org.apache.camel.example.osgi,20,326,251,577,8,28.85
camel,org.apache.camel.component.cxf.holder,16,461,115,576,12,36.0
camel,org.apache.camel.component.rest.openapi.validator.client,9,551,25,576,4,64.0
camel,test.java.org.apache.camel.component.hystrix,1,0,575,575,7,575.0
camel,org.apache.camel.example.spring.javaconfig,24,303,272,575,5,23.958333333333332
camel,test.java.org.apache.camel.component.aws2.sqs.integration,1,0,575,575,6,575.0
camel,org.apache.camel.component.jgroups.raft.springboot,8,287,287,574,2,71.75
camel,org.apache.camel.dataformat.bindy.fixed.skipheader,14,499,74,573,4,40.92857142857143
camel,org.apache.camel.spring.processor.idempotent,29,476,97,573,9,19.75862068965517
camel,org.apache.camel.component.jsonpatch,14,537,35,572,9,40.857142857142854
camel,test.java.org.apache.camel.component.gae.task,3,0,571,571,7,190.33333333333334
camel,org.apache.camel.componenet.cmis,4,564,7,571,4,142.75
camel,generated.java.org.apache.camel.component.solr,2,0,570,570,3,285.0
camel,org.apache.camel.example.splunk,6,285,285,570,7,95.0
camel,org.apache.camel.main.util,29,508,61,569,7,19.620689655172413
camel,org.apache.camel.component.openstack.common,16,406,163,569,5,35.5625
camel,org.apache.camel.component.twitter.util,23,463,105,568,4,24.695652173913043
camel,org.apache.camel.dataformat.bindy.fixed.unmarshall.simple.trimfield,12,519,49,568,2,47.333333333333336
camel,org.apache.camel.queue,13,410,158,568,4,43.69230769230769
camel,org.apache.camel.reactive,15,498,69,567,7,37.8
camel,test.java.org.apache.camel.component.beanstalk.integration,1,0,567,567,7,567.0
camel,org.apache.camel.tooling.util.srcgen,12,424,142,566,8,47.166666666666664
camel,org.apache.camel.component.stitch.client,3,553,12,565,8,188.33333333333334
camel,org.apache.camel.component.solr.converter,2,557,8,565,4,282.5
camel,org.apache.camel.component.google.storage.integration,10,548,17,565,5,56.5
camel,org.apache.camel.converter.saxon,28,493,72,565,3,20.178571428571427
camel,org.apache.camel.component.xmlsecurity.util,11,455,110,565,6,51.36363636363637
camel,org.apache.camel.component.fhir.dataformat.spring,17,438,126,564,6,33.1764705882353
camel,org.apache.camel.component.irc.it,16,312,252,564,16,35.25
camel,org.apache.camel.component.aws2.s3.client.impl,16,498,65,563,6,35.1875
camel,org.apache.camel.component.urlrewrite.http,7,514,49,563,8,80.42857142857143
camel,org.apache.camel.component.atomix.client.set.springboot,12,209,353,562,2,46.833333333333336
camel,org.apache.camel.component.atmos.dto,9,281,281,562,5,62.44444444444444
camel,org.apache.camel.component.restbinding,9,472,90,562,7,62.44444444444444
camel,org.apache.camel.dataformat.bindy.util,32,390,171,561,6,17.53125
camel,org.apache.camel.component.master.springboot,12,280,280,560,2,46.666666666666664
camel,org.apache.camel.test.infra.arangodb.services,25,447,112,559,8,22.36
camel,org.apache.camel.component.sql.sspt.ast,2,370,189,559,5,279.5
camel,org.apache.camel.component.kubernetes.ha.utils,4,549,9,558,4,139.5
camel,org.apache.camel.component.rxjava.engine,17,292,266,558,9,32.8235294117647
camel,org.apache.camel.component.urlrewrite.http4,4,511,47,558,8,139.5
camel,generated.java.org.apache.camel.component.azure.storage.datalake,1,0,557,557,3,557.0
camel,org.apache.camel.component.bean.pojomessage,10,362,195,557,6,55.7
camel,org.apache.camel.test.perf.esb,6,524,32,556,9,92.66666666666667
camel,org.apache.camel.component.infinispan.springboot.customizer,5,278,278,556,4,111.2
camel,org.apache.camel.component.pulsar.utils,16,488,68,556,5,34.75
camel,org.apache.camel.component.kafka.consumer.support.batching,11,460,96,556,2,50.54545454545455
camel,org.apache.camel.component.openshift.producer,18,377,179,556,3,30.88888888888889
camel,org.apache.camel.spring.file,29,386,169,555,12,19.137931034482758
camel,test.java.org.apache.camel.zipkin.scribe,2,0,554,554,9,277.0
camel,test.java.org.apache.camel.component.azure.storage.queue,1,0,554,554,5,554.0
camel,org.apache.camel.component.etcd.springboot.cloud,10,404,149,553,5,55.3
camel,test.java.org.apache.camel.component.javaspace,1,0,552,552,9,552.0
camel,generated.java.org.apache.camel.component.aws.swf,1,0,552,552,3,552.0
camel,org.apache.camel.language.property.springboot,22,275,275,550,5,25.0
camel,net.javacrumbs.calc.model,9,401,149,550,4,61.111111111111114
camel,org.apache.camel.component.service.springboot,10,275,275,550,2,55.0
camel,org.apache.camel.main.xml,11,485,64,549,3,49.90909090909091
camel,org.apache.camel.test.infra.minio.services,16,444,104,548,7,34.25
camel,org.apache.camel.component.zookeepermaster.group.internal.osgi,6,274,274,548,2,91.33333333333333
camel,com.sforce.eventbus,1,548,0,548,1,548.0
camel,org.apache.camel.component.olingo4.api,7,396,151,547,2,78.14285714285714
camel,org.apache.camel.core.osgi.utils,26,273,273,546,4,21.0
camel,org.apache.camel.component.milo.converter,18,419,127,546,4,30.333333333333332
camel,org.apache.camel.component.aws.xray.decorators.http,9,450,95,545,12,60.55555555555556
camel,org.apache.camel.component.file.ha,4,541,4,545,4,136.25
camel,test.java.org.apache.camel.component.aws.msk,1,0,544,544,6,544.0
camel,org.apache.camel.component.google.bigquery.integration.sql,11,519,25,544,7,49.45454545454545
camel,org.apache.camel.support.builder.xml,26,389,155,544,11,20.923076923076923
camel,org.apache.camel.reifier.transformer,26,418,126,544,20,20.923076923076923
camel,org.apache.camel.component.aws2.ec2.integration,12,394,150,544,4,45.333333333333336
camel,org.apache.camel.maven.model,10,331,212,543,6,54.3
camel,test.java.org.apache.camel.converter.xmlbeans,2,0,543,543,6,271.5
camel,org.apache.camel.component.queue,24,258,284,542,6,22.583333333333332
camel,org.apache.camel.component.minio.integration.localTests,1,529,13,542,7,542.0
camel,org.apache.camel.language.ref.springboot,23,271,271,542,6,23.565217391304348
camel,test.java.org.apache.camel.test.blueprint.component.rest,1,0,542,542,10,542.0
camel,org.apache.camel.ruby,18,354,188,542,5,30.11111111111111
camel,org.apache.camel.component.pulsar.configuration,19,465,77,542,1,28.526315789473685
camel,org.apache.camel.test.infra.hivemq.services,10,492,50,542,11,54.2
camel,test.java.org.apache.camel.component.atom,2,0,542,542,8,271.0
camel,generated.java.org.apache.camel.component.milo.client,1,0,541,541,3,541.0
camel,test.java.org.apache.camel.component.jira.mocks,1,0,541,541,5,541.0
camel,test.java.org.apache.camel.component.cxf.cxfbean,1,0,541,541,5,541.0
camel,generated.java.org.apache.camel.converter,3,0,540,540,9,180.0
camel,org.apache.camel.language.constant.springboot,21,270,270,540,5,25.714285714285715
camel,org.apache.camel.dataformat.bindy.model.simple.oneclassandskipfirstline,7,348,191,539,1,77.0
camel,org.apache.camel.component.caffeine.loadcache,21,456,83,539,3,25.666666666666668
camel,org.apache.camel.component.kafka.serde,13,456,83,539,9,41.46153846153846
camel,org.apache.camel.component.mongodb3.converters,9,386,152,538,2,59.77777777777778
camel,org.apache.camel.component.mybatis.bean,9,478,60,538,7,59.77777777777778
camel,org.apache.camel.language.header.springboot,21,269,269,538,5,25.61904761904762
camel,org.apache.camel.component.spring.ws.type,17,336,201,537,2,31.58823529411765
camel,org.apache.activemq.camel.component,3,496,41,537,1,179.0
camel,org.apache.camel.example.cxf.jaxrs.resources,11,268,268,536,5,48.72727272727273
camel,org.apache.camel.component.dns.types,15,416,120,536,6,35.733333333333334
camel,org.apache.camel.component.hystrix.springboot,8,285,250,535,4,66.875
camel,test.java.org.apache.camel.itest.osgi.zookeeper,1,0,534,534,2,534.0
camel,org.apache.camel.component.dns.springboot.cloud,9,389,144,533,5,59.22222222222222
camel,org.apache.camel.component.kura,21,338,194,532,2,25.333333333333332
camel,org.apache.camel.example.model,8,266,266,532,3,66.5
camel,org.apache.camel.example.cdi.xml,10,317,215,532,2,53.2
camel,org.apache.camel.example.sql,9,266,266,532,4,59.111111111111114
camel,org.apache.camel.test.infra.qdrant.services,12,475,56,531,8,44.25
camel,org.apache.camel.component.cloudevents.transformer,8,486,44,530,4,66.25
camel,org.apache.camel.example.cxf.httptojms,12,62,467,529,6,44.083333333333336
camel,test.java.org.apache.camel.component.kafka.embedded,2,0,529,529,5,264.5
camel,org.apache.camel.component.zeebe.internal,2,528,1,529,3,264.5
camel,org.apache.camel.component.nsq.springboot,10,264,264,528,2,52.8
camel,org.apache.camel.dataformat.bindy.fixed.unmarshall.simple.method,7,494,33,527,2,75.28571428571429
camel,generated.java.org.apache.camel.component.elsql,1,0,527,527,3,527.0
camel,test.java.org.apache.camel.component.aws2.sts,2,0,526,526,6,263.0
camel,org.apache.camel.dataformat.any23.springboot,9,263,263,526,4,58.44444444444444
camel,org.apache.camel.component.graphql.server,8,454,72,526,6,65.75
camel,org.apache.camel.itest.osgi.sql,13,438,87,525,3,40.38461538461539
camel,org.apache.camel.component.consul.processor.service,3,460,65,525,5,175.0
camel,org.apache.camel.itest.osgi.cxf,21,411,113,524,5,24.952380952380953
camel,org.apache.camel.test.infra.couchdb.services,15,414,109,523,7,34.86666666666667
camel,org.apache.camel.component.kafka.consumer.errorhandler,11,476,47,523,8,47.54545454545455
camel,test.java.org.apache.camel.dataformat.jibx,1,0,523,523,7,523.0
camel,org.apache.camel.component.aws.s3.integration,13,443,76,519,3,39.92307692307692
camel,test.java.org.apache.camel.component.disruptor,2,0,518,518,2,259.0
camel,org.apache.camel.example.spark,16,259,259,518,9,32.375
camel,org.apache.camel.processor.idempotent.hazelcast,26,422,95,517,3,19.884615384615383
camel,org.apache.camel.component.krati.processor.idempotent,12,324,192,516,2,43.0
camel,org.apache.camel.oaipmh.utils,8,485,31,516,3,64.5
camel,org.apache.camel.component.xslt.extensions,13,425,90,515,6,39.61538461538461
camel,org.apache.camel.maven.dsl.yaml.support,10,502,13,515,5,51.5
camel,org.apache.camel.component.google.pubsub.unit,14,473,42,515,6,36.785714285714285
camel,org.apache.camel.itest.osgi.bindy,3,505,9,514,5,171.33333333333334
camel,org.apache.camel.component.micrometer.springboot,10,257,257,514,2,51.4
camel,org.apache.camel.component.splunk.integration,12,444,68,512,10,42.666666666666664
camel,org.apache.camel.component.kubernetes.replication_controllers.springboot,10,256,256,512,2,51.2
camel,org.apache.camel.component.kubernetes.persistent_volumes_claims.springboot,10,256,256,512,2,51.2
camel,org.apache.camel.component.jira.oauth,11,486,26,512,5,46.54545454545455
camel,org.apache.camel.zipkin.http,5,450,61,511,8,102.2
camel,org.apache.camel.component.platform.http.main.authentication,5,482,28,510,6,102.0
camel,org.apache.camel.component.kubernetes.persistent_volumes.springboot,10,255,255,510,2,51.0
camel,org.apache.camel.component.kubernetes.resources_quota.springboot,10,255,255,510,2,51.0
camel,org.apache.camel.component.google.bigquery.unit,12,424,86,510,5,42.5
camel,org.apache.camel.component.gae.bind,5,255,255,510,5,102.0
camel,generated.java.org.apache.camel.component.google.calendar.stream,1,0,508,508,3,508.0
camel,test.java.org.apache.camel.dataformat.hessian,1,0,508,508,6,508.0
camel,org.apache.camel.processor.throttle.requests,6,485,22,507,5,84.5
camel,test.java.org.apache.camel.spring.config,4,0,507,507,10,126.75
camel,org.apache.camel.component.thrift.springboot,10,253,253,506,2,50.6
camel,org.apache.camel.avro.test,4,316,190,506,6,126.5
camel,org.apache.camel.component.kubernetes.services.springboot,11,253,253,506,2,46.0
camel,org.apache.camel.spring.produce,25,405,100,505,9,20.2
camel,test.java.org.apache.camel.component.krati,1,0,505,505,8,505.0
camel,org.apache.camel.dataformat.bindy.model.complex.twoclassesandonelink,12,372,132,504,3,42.0
camel,org.apache.camel.component.dynamicrouter.processor,1,503,0,503,3,503.0
camel,test.java.org.apache.camel.component.azure.common,1,0,503,503,3,503.0
camel,org.apache.camel.component.aws2.lambda.integration,19,343,160,503,10,26.473684210526315
camel,org.apache.camel.example.micrometer,9,267,236,503,4,55.888888888888886
camel,org.apache.camel.itest.osgi.base64,2,346,156,502,1,251.0
camel,org.apache.camel.component.kubernetes.config_maps.springboot,10,251,251,502,2,50.2
camel,org.apache.camel.component.kubernetes.namespaces.springboot,10,251,251,502,2,50.2
camel,org.apache.camel.component.kubernetes.secrets.springboot,10,251,251,502,2,50.2
camel,org.apache.camel.component.kubernetes.deployments.springboot,10,251,251,502,2,50.2
camel,org.apache.camel.test.stub.tcp,4,477,25,502,3,125.5
camel,test.java.org.apache.camel.component.neo4j,1,0,502,502,5,502.0
camel,generated.java.org.apache.camel.component.hdfs,1,0,502,502,3,502.0
camel,org.apache.camel.cdi.support,13,444,56,500,10,38.46153846153846
camel,org.apache.camel.component.kubernetes.service_accounts.springboot,9,250,250,500,2,55.55555555555556
camel,org.apache.camel.component.jetty.javabody,15,383,116,499,4,33.266666666666666
camel,org.apache.camel.example.websocket,20,249,249,498,2,24.9
camel,generated.java.org.apache.camel.component.milo.browse,1,0,498,498,3,498.0
camel,org.apache.camel.component.aws2.firehose.client.impl,10,456,41,497,4,49.7
camel,org.apache.camel.component.jetty11,9,114,383,497,9,55.22222222222222
camel,org.apache.camel.component.etcd3.integration,2,497,0,497,2,248.5
camel,org.apache.camel.itest.osgi.cache,10,408,89,497,3,49.7
camel,test.java.org.apache.camel.component.etcd3.integration,1,0,497,497,2,497.0
camel,generated.java.org.apache.camel.component.azure.storage.blob,1,0,496,496,3,496.0
camel,test.java.org.apache.camel.itest.osgi.bindy,1,0,496,496,5,496.0
camel,test.java.org.apache.camel.component.optaplanner,2,0,496,496,7,248.0
camel,org.apache.camel.test.tcp,14,400,95,495,2,35.357142857142854
camel,org.apache.camel.component.mongodb.meta,10,328,167,495,2,49.5
camel,org.apache.camel.example.transformer.demo,7,247,247,494,4,70.57142857142857
camel,org.apache.camel.dataformat.bindy.model.fix.complex.onetomany,9,427,67,494,4,54.888888888888886
camel,test.java.org.apache.camel.component.http.helper,3,0,493,493,4,164.33333333333334
camel,test.java.org.apache.camel.component.routebox,1,0,493,493,5,493.0
camel,org.apache.camel.component.soroushbot.component.springboot,6,246,246,492,2,82.0
camel,org.apache.camel.component.ibatis.strategy,8,246,246,492,3,61.5
camel,org.apache.camel.example.mybatis,5,246,246,492,4,98.4
camel,test.java.org.apache.camel.test.perf.esb,1,0,492,492,9,492.0
camel,org.apache.camel.dsl.jbang.core.commands.generate,9,441,51,492,4,54.666666666666664
camel,test.java.org.apache.camel.test.infra.hdfs.v2.services,2,0,492,492,9,246.0
camel,org.apache.camel.spring.config.scan,24,345,146,491,3,20.458333333333332
camel,org.apache.camel.test.infra.opensearch.services,12,419,72,491,7,40.916666666666664
camel,org.apache.camel.component.cxf.wssecurity.server,16,325,166,491,4,30.6875
camel,org.apache.camel.example.debezium,8,245,245,490,2,61.25
camel,generated.java.org.apache.camel.component.sip,1,0,489,489,3,489.0
camel,org.apache.camel.test.infra.services.kafka,3,457,31,488,11,162.66666666666666
camel,org.apache.camel.example.cxf.incident,5,244,244,488,5,97.6
camel,org.apache.camel.component.amqp.artemis,16,343,145,488,2,30.5
camel,org.apache.camel.test.main.junit5.legacy,8,470,17,487,14,60.875
camel,test.java.org.apache.camel.generator.swagger,1,0,487,487,6,487.0
camel,org.apache.camel.http.common.cookie,11,405,82,487,5,44.27272727272727
camel,generated.java.org.apache.camel.component.google.sheets.stream,1,0,487,487,3,487.0
camel,org.apache.camel.github,13,433,53,486,9,37.38461538461539
camel,test.java.org.apache.camel.dsl.xml.jaxb.management,1,0,485,485,4,485.0
camel,test.java.org.apache.camel.converter.dozer,1,0,485,485,8,485.0
camel,org.apache.camel.component.atmos.util,9,242,242,484,6,53.77777777777778
camel,test.java.org.apache.camel.component.hashicorp.vault.integration,1,0,484,484,1,484.0
camel,org.apache.camel.component.kubernetes.pods.springboot,9,241,241,482,2,53.55555555555556
camel,generated.java.org.apache.camel.component.aws.ddbstream,1,0,482,482,4,482.0
camel,org.apache.camel.component.kubernetes.nodes.springboot,9,241,241,482,2,53.55555555555556
camel,test.java.org.apache.camel.component.azure.queue,1,0,482,482,4,482.0
camel,org.apache.camel.component.aws2.lambda.client.impl,9,443,37,480,4,53.333333333333336
camel,org.apache.camel.test.infra.redis.services,17,391,89,480,9,28.235294117647058
camel,org.apache.camel.component.file.azure.strategy,2,479,1,480,4,240.0
camel,generated.java.org.apache.camel.component.microprofile.metrics,2,0,479,479,6,239.5
camel,org.apache.camel.support.jndi,30,320,159,479,13,15.966666666666667
camel,org.apache.camel.component.dynamicrouter.support,6,379,100,479,2,79.83333333333333
camel,test.java.org.apache.camel.component.atmos.integration.producer,1,0,479,479,7,479.0
camel,org.apache.camel.test.infra.etcd3.services,12,274,205,479,7,39.916666666666664
camel,generated.java.org.apache.camel.component.etcd3,1,0,479,479,3,479.0
camel,org.apache.camel.dataformat.iso8583,5,470,8,478,6,95.6
camel,test.java.org.apache.camel.component.servicenow,2,0,478,478,4,239.0
camel,org.apache.camel.jsonpath.easypredicate,12,377,100,477,4,39.75
camel,org.apache.camel.component.twitter.producer,16,371,106,477,5,29.8125
camel,org.apache.camel.component.aws2.ddb.transform,6,472,5,477,3,79.5
camel,test.java.org.apache.camel.dataformat.castor,1,0,477,477,6,477.0
camel,org.apache.camel.component.spring.jdbc,11,443,34,477,10,43.36363636363637
camel,org.apache.camel.processor.lucene,30,363,114,477,3,15.9
camel,org.apache.camel.component.olingo4.internal,17,384,92,476,5,28.0
camel,org.apache.camel.test.infra.hashicorp.vault.services,28,362,114,476,5,17.0
camel,org.apache.camel.component.mongodb3.springboot,18,335,141,476,5,26.444444444444443
camel,test.java.org.apache.camel.component.aws.ec2.integration,2,0,475,475,2,237.5
camel,generated.java.org.apache.camel.component.google.storage,1,0,475,475,3,475.0
camel,com.viwilo.camel,1,475,0,475,6,475.0
camel,org.apache.camel.component.es.converter,4,460,15,475,2,118.75
camel,org.apache.camel.component.avro.processors,9,336,138,474,8,52.666666666666664
camel,org.apache.camel.component.jcache.processor.idempotent,17,386,88,474,3,27.88235294117647
camel,org.apache.camel.component.mongodb.verifier,12,307,167,474,2,39.5
camel,org.apache.camel.itest.highvolume,5,237,237,474,4,94.8
camel,org.apache.camel.component.ldif.springboot,9,237,237,474,2,52.666666666666664
camel,org.apache.camel.component.nitrite.operation.common,2,464,10,474,11,237.0
camel,org.apache.camel.component.kubernetes.hpa.springboot,9,237,237,474,2,52.666666666666664
camel,test.java.org.apache.camel.component.cxf.jaxrs,4,0,473,473,5,118.25
camel,org.apache.camel.component.rocketmq.reply,3,470,3,473,6,157.66666666666666
camel,org.apache.camel.component.xchange.springboot,9,236,236,472,2,52.44444444444444
camel,org.apache.camel.component.jsonvalidator.springboot,9,236,236,472,2,52.44444444444444
camel,org.apache.camel.component.kubernetes.job.springboot,8,236,236,472,2,59.0
camel,org.apache.camel.component.aws.sdb.integration,8,415,57,472,2,59.0
camel,org.apache.camel.component.aws2.sns.client.impl,11,442,30,472,6,42.90909090909091
camel,org.apache.camel.test.infra.openldap.services,15,381,90,471,9,31.4
camel,org.apache.camel.component.ipfs.springboot,7,235,235,470,2,67.14285714285714
camel,org.apache.camel.websocket.jsr356.springboot,7,235,235,470,2,67.14285714285714
camel,test.java.org.apache.camel.component.dozer.example.abc,1,0,470,470,2,470.0
camel,org.apache.camel.tools.apt.util,9,410,60,470,4,52.22222222222222
camel,org.apache.camel.component.grok.springboot,2,235,235,470,2,235.0
camel,org.apache.camel.component.zeebe.processor,5,454,15,469,6,93.8
camel,org.apache.camel.dsl.jbang.core.commands.k.support,3,430,39,469,8,156.33333333333334
camel,org.apache.camel.component.langchain4j.chat.tool,4,234,234,468,4,117.0
camel,org.apache.camel.component.aws.xray.decorators,8,443,25,468,9,58.5
camel,org.apache.camel.component.iota.springboot,7,234,234,468,2,66.85714285714286
camel,org.apache.camel.component.aries.processor,2,234,234,468,3,234.0
camel,org.apache.camel.spring.impl,16,446,22,468,9,29.25
camel,org.apache.camel.itest.osgi.core.log,7,359,108,467,3,66.71428571428571
camel,test.java.org.apache.camel.component.gae.mail,3,0,467,467,7,155.66666666666666
camel,test.java.org.apache.camel.component.azure.storage.queue.operations,1,0,467,467,3,467.0
camel,org.apache.camel.component.ibm.secrets.manager.integration.operations,5,462,4,466,4,93.2
camel,org.apache.camel.component.chatscript.springboot,6,233,233,466,2,77.66666666666667
camel,test.java.org.apache.camel.spring.javaconfig.test,3,0,466,466,8,155.33333333333334
camel,org.apache.camel.itest.springboot.arquillian,6,449,17,466,4,77.66666666666667
camel,org.apache.camel.component.pg.replication.slot.springboot,4,232,232,464,2,116.0
camel,test.java.org.apache.camel.component.urlrewrite.http4,1,0,464,464,7,464.0
camel,org.apache.camel.component.olingo2.internal,16,373,91,464,5,29.0
camel,test.java.org.apache.camel.component.urlrewrite.http,1,0,464,464,7,464.0
camel,org.apache.camel.component.cxf.transport.blueprint,9,231,231,462,4,51.333333333333336
camel,org.apache.camel.component.mail.security,21,367,95,462,5,22.0
camel,test.java.org.apache.camel.component.aws2.ecs,2,0,462,462,4,231.0
camel,org.apache.camel.telemetry.propagation,1,462,0,462,8,462.0
camel,org.apache.camel.component.jetty.proxy,15,393,67,460,11,30.666666666666668
camel,org.apache.camel.itest.osgi.restlet.example,7,424,34,458,7,65.42857142857143
camel,org.apache.camel.dataformat.beanio.csv,11,414,44,458,2,41.63636363636363
camel,test.java.org.apache.camel.component.rest,3,0,457,457,5,152.33333333333334
camel,org.beverage,5,251,205,456,5,91.2
camel,org.apache.camel.component.jms.tuning,28,347,109,456,3,16.285714285714285
camel,org.apache.camel.component.zookeeper.cluster,29,229,227,456,9,15.724137931034482
camel,org.apache.camel.itest.osgi.cxf.blueprint.jaxrs.testbean,2,408,48,456,5,228.0
camel,test.java.org.apache.activemq.camel.component,2,0,455,455,1,227.5
camel,org.apache.camel.component.jms.discovery,39,318,137,455,3,11.666666666666666
camel,test.java.org.apache.camel.spring.cloud,3,0,454,454,4,151.33333333333334
camel,org.apache.camel.catalog.springboot,12,297,157,454,6,37.833333333333336
camel,org.apache.camel.support.scan,12,363,90,453,11,37.75
camel,org.apache.camel.component.caffeine.processor.idempotent,18,412,41,453,4,25.166666666666668
camel,org.apache.camel.reifier.validator,23,345,108,453,16,19.695652173913043
camel,org.apache.camel.ldap,1,452,0,452,5,452.0
camel,org.apache.camel.component.cxf.wsrm,17,374,78,452,8,26.58823529411765
camel,test.java.org.apache.camel.component.azure.servicebus.integration,1,0,452,452,3,452.0
camel,org.apache.camel.dsl.jbang.core.commands.test,3,443,8,451,3,150.33333333333334
camel,org.apache.camel.support.startup,12,366,85,451,7,37.583333333333336
camel,org.apache.camel.dsl.yaml.common.exception,7,416,35,451,14,64.42857142857143
camel,org.apache.camel.component.crypto.processor,15,404,46,450,4,30.0
camel,org.apache.camel.commands.catalog,9,416,34,450,5,50.0
camel,org.apache.camel.jbang.console,5,362,88,450,3,90.0
camel,org.apache.camel.component.opensearch.converter,3,439,10,449,2,149.66666666666666
camel,generated.java.org.apache.camel.component.azure.eventhubs,1,0,449,449,3,449.0
camel,org.apache.camel.eclipse,3,282,167,449,6,149.66666666666666
camel,org.apache.camel.test.infra.xmpp.services,17,342,107,449,9,26.41176470588235
camel,test.java.org.apache.camel.util.concurrent,3,0,448,448,3,149.33333333333334
camel,org.apache.camel.component.aws2.ddbstream.client.impl,7,430,17,447,4,63.857142857142854
camel,org.apache.camel.component.spring.security.config,17,356,91,447,4,26.294117647058822
camel,generated.java.org.apache.camel.component.azure.blob,1,0,446,446,3,446.0
camel,org.apache.camel.component.aws2.translate.client.impl,8,429,16,445,4,55.625
camel,org.apache.camel.component.aws2.mq.client.impl,8,428,17,445,4,55.625
camel,org.apache.camel.test.infra.pulsar.services,35,361,83,444,7,12.685714285714285
camel,org.apache.camel.dataformat.thrift.springboot,9,222,222,444,2,49.333333333333336
camel,org.apache.camel.component.aws2.cw.client.impl,8,427,16,443,4,55.375
camel,test.java.org.apache.camel.component.sjms.jms,2,0,443,443,3,221.5
camel,test.java.org.apache.camel.component.smpp,3,0,443,443,3,147.66666666666666
camel,org.apache.camel.itest.osgi.hl7,11,343,100,443,3,40.27272727272727
camel,org.apache.camel.dataformat.asn1.springboot,9,221,221,442,2,49.111111111111114
camel,org.apache.camel.dsl.jbang.core.generator,3,221,221,442,4,147.33333333333334
camel,org.apache.camel.component.routebox.strategy,12,221,221,442,2,36.833333333333336
camel,test.java.org.apache.camel.component.microprofile.metrics.message.history,2,0,442,442,4,221.0
camel,generated.java.org.apache.camel.component.yammer,1,0,442,442,3,442.0
camel,org.apache.camel.component.aws2.ec2.client.impl,7,426,15,441,4,63.0
camel,org.apache.camel.component.aws.secretsmanager.client.impl,8,427,14,441,4,55.125
camel,generated.java.org.apache.camel.component.corda,1,0,441,441,4,441.0
camel,org.apache.camel.component.dummy,13,416,23,439,11,33.76923076923077
camel,test.java.org.apache.camel.example.cdi.osgi,2,0,439,439,2,219.5
camel,generated.java.org.apache.camel.component.atomix.client.messaging,1,0,438,438,4,438.0
camel,org.apache.camel.component.platform.http.springboot,3,219,219,438,2,146.0
camel,org.apache.camel.component.jms.remoting,20,351,87,438,8,21.9
camel,org.apache.camel.component.smb.strategy,3,431,7,438,4,146.0
camel,test.java.org.apache.camel.itest.osgi.cxf.blueprint,1,0,438,438,3,438.0
camel,test.java.org.apache.camel.component.consul.springboot.cloud,3,0,438,438,4,146.0
camel,org.apache.camel.component.aws2.msk.client.impl,8,424,13,437,4,54.625
camel,org.apache.camel.component.aws2.iam.client.impl,7,424,13,437,4,62.42857142857143
camel,org.apache.camel.component.aws2.eventbridge.client.impl,7,424,13,437,4,62.42857142857143
camel,org.apache.camel.component.kudu.springboot,3,218,218,436,2,145.33333333333334
camel,org.apache.camel.component.nitrite.springboot,4,218,218,436,2,109.0
camel,org.apache.camel.component.file.consumer,11,324,112,436,11,39.63636363636363
camel,test.java.org.apache.camel.component.xslt,7,0,436,436,7,62.285714285714285
camel,org.apache.camel.component.aws2.ses.client.impl,8,423,12,435,4,54.375
camel,org.apache.camel.component.spring.ws.security,17,292,143,435,3,25.58823529411765
camel,org.apache.camel.component.aws2.ddb.client.impl,7,423,12,435,4,62.142857142857146
camel,test.java.org.apache.camel.component.kafka,3,0,434,434,5,144.66666666666666
camel,test.java.org.apache.camel.microprofile.health,1,0,434,434,3,434.0
camel,generated.java.org.apache.camel.component.atomix.client.map,1,0,433,433,4,433.0
camel,org.apache.camel.component.aws2.ecs.client.impl,7,422,11,433,4,61.857142857142854
camel,org.apache.camel.component.aws2.kms.client.impl,7,422,11,433,4,61.857142857142854
camel,org.apache.camel.component.aws2.eks.client.impl,7,422,11,433,4,61.857142857142854
camel,org.apache.camel.processor.mllp,14,347,86,433,2,30.928571428571427
camel,test.java.org.apache.camel.itest.springboot.arquillian,1,0,432,432,4,432.0
camel,org.apache.camel.component.graphql.springboot,3,216,216,432,2,144.0
camel,org.apache.camel.dataformat.smooks,5,421,10,431,4,86.2
camel,org.apache.camel.support.http,16,399,32,431,3,26.9375
camel,org.apache.camel.itest.osgi.servlet,22,296,133,429,3,19.5
camel,org.apache.camel.itest.osgi.jclouds,17,336,93,429,3,25.235294117647058
camel,org.apache.camel.test.infra.microprofile.lra.services,14,363,66,429,7,30.642857142857142
camel,test.java.org.apache.camel.component.gora,2,0,428,428,4,214.0
camel,test.java.org.apache.camel.pgevent,2,0,428,428,4,214.0
camel,org.apache.camel.component.micrometer.spi,13,347,81,428,3,32.92307692307692
camel,org.apache.camel.component.couchbase.integration,26,288,140,428,6,16.46153846153846
camel,org.apache.camel.component.test.springboot,19,305,122,427,3,22.473684210526315
camel,test.java.org.apache.camel.component.rss,3,0,426,426,6,142.0
camel,test.java.org.apache.camel.component.pubnub.example,2,0,425,425,7,212.5
camel,generated.java.org.apache.camel.component.google.mail.stream,1,0,425,425,3,425.0
camel,org.apache.camel.dataformat.bindy.fixed.delimited,11,372,53,425,1,38.63636363636363
camel,org.apache.camel.component.hazelcast.listener,16,371,53,424,6,26.5
camel,org.apache.camel.pollconsumer.quartz,21,289,135,424,5,20.19047619047619
camel,org.apache.camel.component.cm.exceptions.cmresponse,5,331,93,424,18,84.8
camel,org.apache.camel.component.aws.cloudtrail.client.impl,6,418,6,424,4,70.66666666666667
camel,org.apache.camel.language.python,4,413,10,423,6,105.75
camel,test.java.org.apache.camel.scr,1,0,422,422,5,422.0
camel,org.apache.camel.component.microprofile.metrics.gauge,5,195,227,422,6,84.4
camel,org.apache.camel.reactive.vertx,17,328,93,421,3,24.764705882352942
camel,org.apache.camel.component.sql.sspt,2,350,69,419,7,209.5
camel,org.apache.camel.maven.resources,6,209,209,418,2,69.66666666666667
camel,org.apache.camel.test.blueprint.management,13,375,43,418,5,32.15384615384615
camel,org.apache.camel.test.infra.common,12,401,16,417,7,34.75
camel,test.java.org.apache.camel.generator.openapi,2,0,416,416,3,208.0
camel,org.apache.camel.component.yql.springboot,8,208,208,416,2,52.0
camel,test.java.org.apache.camel.component.etcd.cloud.integration,1,0,416,416,4,416.0
camel,org.apache.camel.component.jsonapi.springboot,5,207,207,414,2,82.8
camel,org.apache.camel.main.support,9,401,13,414,4,46.0
camel,generated.java.org.apache.camel.component.atomix.client.set,1,0,414,414,4,414.0
camel,org.apache.camel.examples.cluster,6,207,207,414,4,69.0
camel,org.apache.camel.component.aws2.textract.client.impl,1,413,0,413,4,413.0
camel,org.apache.camel.component.aws2.bedrock.agent.client.impl,1,413,0,413,4,413.0
camel,generated.java.org.apache.camel.component.atomix.client.queue,1,0,413,413,4,413.0
camel,org.apache.camel.component.aws2.bedrock.agentruntime.client.impl,1,413,0,413,4,413.0
camel,org.apache.camel.component.aws2.bedrock.client.impl,1,413,0,413,4,413.0
camel,org.apache.camel.component.cxf.multipart,21,307,105,412,5,19.61904761904762
camel,org.apache.camel.language.wasm,4,380,31,411,3,102.75
camel,org.apache.camel.component.aws.config.client.impl,2,411,0,411,4,205.5
camel,test.java.org.apache.camel.component.google.bigquery.unit.sql,1,0,411,411,5,411.0
camel,org.apache.camel.component.file.watch.constants,8,279,132,411,2,51.375
camel,org.apache.camel.example.tracer,8,205,205,410,4,51.25
camel,generated.java.org.apache.camel.component.atomix.client.value,1,0,410,410,4,410.0
camel,test.java.org.apache.camel,6,0,410,410,6,68.33333333333333
camel,org.apache.camel.component.couchdb.integration,5,241,169,410,2,82.0
camel,org.apache.camel.component.cxf.transport.spring,16,284,125,409,8,25.5625
camel,org.apache.camel.component.torchserve.producer,2,378,30,408,4,204.0
camel,test.java.org.apache.camel.test.infra.aws.services,1,0,408,408,7,408.0
camel,org.apache.camel.oauth.vertx,4,324,84,408,3,102.0
camel,org.apache.camel.component.soroushbot.support,10,385,23,408,4,40.8
camel,org.apache.camel.reload,2,2,405,407,2,203.5
camel,org.apache.camel.component.spring.ws.testfilters,6,257,149,406,3,67.66666666666667
camel,org.apache.camel.component.spark.annotations,13,203,203,406,3,31.23076923076923
camel,test.java.org.apache.camel.maven,3,0,406,406,6,135.33333333333334
camel,test.java.org.apache.camel.spring.boot.issues,1,0,405,405,5,405.0
camel,org.apache.camel.itest.osgi.hdfs,13,287,118,405,2,31.153846153846153
camel,test.java.org.apache.camel.component.apns,1,0,405,405,4,405.0
camel,org.apache.camel.test.infra.milvus.services,13,366,38,404,7,31.076923076923077
camel,org.apache.camel.converter.jaxb.person,8,318,86,404,3,50.5
camel,org.apache.camel.dataformat.bindy.fixed.dynamic,13,351,53,404,1,31.076923076923077
camel,org.apache.camel.dsl.xml.io.beans,8,383,21,404,9,50.5
camel,org.apache.camel.component.slack.helper,14,354,49,403,2,28.785714285714285
camel,org.apache.camel.example.telegram.usage,7,201,201,402,6,57.42857142857143
camel,generated.java.org.apache.camel.component.atomix.client.multimap,1,0,402,402,4,402.0
camel,org.apache.camel.component.platform.http.cookie,3,384,18,402,3,134.0
camel,org.apache.camel.test.infra.azure.common.services,34,314,88,402,7,11.823529411764707
camel,test.java.org.apache.camel.example.cdi.test,1,0,400,400,7,400.0
camel,org.apache.camel.component.platform.http.spi,12,350,49,399,7,33.25
camel,org.apache.camel.component.jms.integration.spring.tx,7,211,188,399,19,57.0
camel,org.apache.camel.component.netty4.util,5,388,11,399,1,79.8
camel,org.apache.camel.processor.channel,22,200,197,397,3,18.045454545454547
camel,test.java.org.apache.camel.component.milo.browse,1,0,397,397,1,397.0
camel,org.apache.camel.test.infra.messaging.services,10,358,38,396,11,39.6
camel,org.apache.camel.itest.osgi.jetty,14,329,66,395,4,28.214285714285715
camel,org.apache.camel.component.aws2.transcribe.integration,2,392,2,394,3,197.0
camel,test.java.org.apache.camel.component.sjms.producer,3,0,394,394,3,131.33333333333334
camel,org.apache.camel.component.apns.model,9,197,197,394,5,43.77777777777778
camel,org.apache.camel.example.axis,8,278,115,393,4,49.125
camel,org.apache.camel.component.aws2.stepfunctions.client.impl,2,393,0,393,4,196.5
camel,org.apache.camel.test.infra.zookeeper.services,17,317,75,392,8,23.058823529411764
camel,org.apache.camel.example.service,8,196,196,392,6,49.0
camel,org.apache.camel.manual,3,196,196,392,1,130.66666666666666
camel,org.apache.camel.main.xml.spring,10,366,26,392,1,39.2
camel,org.apache.camel.test.infra.google.pubsub.services,16,320,72,392,7,24.5
camel,org.apache.camel.oaipmh.handler,5,372,19,391,5,78.2
camel,test.java.org.apache.camel.cdi.rule,1,0,391,391,5,391.0
camel,test.java.org.apache.camel.main,4,0,391,391,4,97.75
camel,test.java.org.apache.camel.itest.osgi.restlet.example,1,0,390,390,7,390.0
camel,org.apache.camel.karaf.commands.catalog.completers,3,195,195,390,3,130.0
camel,org.apache.camel.dataformat.bindy.model.fix.tab,5,332,57,389,3,77.8
camel,test.java.org.apache.camel.zipkin.http,1,0,389,389,8,389.0
camel,generated.java.org.apache.camel.component.aws.sns,1,0,389,389,3,389.0
camel,org.apache.camel.test.infra.consul.services,12,324,64,388,7,32.333333333333336
camel,org.apache.camel.component.nats.integration,9,293,94,387,21,43.0
camel,org.apache.camel.component.fhir.dataformat,10,302,84,386,4,38.6
camel,org.apache.camel.component.cxf.wssecurity.camel,15,280,106,386,3,25.733333333333334
camel,org.apache.camel.example.jira,3,193,193,386,4,128.66666666666666
camel,test.java.org.apache.camel.dsl.java.joor,2,0,385,385,6,192.5
camel,org.apache.camel.component.azure.servicebus.operations,8,263,122,385,2,48.125
camel,org.apache.camel.component.vertx.kafka.serde,2,256,129,385,6,192.5
camel,org.apache.camel.component.sjms2.producer,11,325,59,384,3,34.90909090909091
camel,org.apache.camel.component.platform.http.plugin,13,312,72,384,3,29.53846153846154
camel,test.java.org.apache.camel.component.aws2.sqs,3,0,383,383,5,127.66666666666667
camel,org.foo.search.springboot,5,348,35,383,3,76.6
camel,org.apache.camel.guice.testing,5,368,15,383,4,76.6
camel,org.apache.camel.example.any23,5,191,191,382,3,76.4
camel,org.apache.camel.component.stax.model,6,353,29,382,6,63.666666666666664
camel,org.apache.camel.test.infra.pinecone.services,3,374,8,382,6,127.33333333333333
camel,org.apache.camel.karaf.commands.completers,13,191,191,382,3,29.384615384615383
camel,test.java.org.apache.camel.component.google.storage.integration,2,0,381,381,3,190.5
camel,org.apache.camel.spring.postprocessor,17,323,58,381,7,22.41176470588235
camel,org.apache.camel.component.salesforce.dto,2,376,5,381,4,190.5
camel,org.apache.camel.component.cxf.wsdl,16,309,72,381,7,23.8125
camel,org.apache.camel.component.cloudevents,10,370,10,380,5,38.0
camel,org.apache.camel.opentelemetry.internal,2,190,190,380,3,190.0
camel,org.apache.camel.component.olingo2.api.batch,8,346,33,379,5,47.375
camel,org.apache.camel.opentracing.starter,9,189,189,378,4,42.0
camel,test.java.org.apache.camel.component.milo.testing,3,0,377,377,3,125.66666666666667
camel,generated.java.org.apache.camel.component.sparkrest,2,0,377,377,5,188.5
camel,org.apache.camel.test.util,5,295,82,377,1,75.4
camel,org.apache.camel.component.atmos.integration.consumer,13,219,158,377,3,29.0
camel,org.apache.camel.spring.boot.properties,2,92,284,376,2,188.0
camel,org.apache.camel.converter.dozer.model,6,337,39,376,4,62.666666666666664
camel,generated.java.org.apache.camel.component.websocket,1,0,375,375,3,375.0
camel,org.apache.camel.component.olingo4.api.batch,6,352,23,375,5,62.5
camel,org.apache.camel.dsl.xml.jaxb.definition,11,219,155,374,17,34.0
camel,org.apache.camel.example.cxf.proxy,7,187,187,374,4,53.42857142857143
camel,org.apache.camel.itest.utils.extensions,7,321,53,374,4,53.42857142857143
camel,org.apache.camel.component.sjms2.support,16,246,128,374,1,23.375
camel,org.apache.camel.osgi.activator,4,129,244,373,2,93.25
camel,org.apache.camel.component.langchain4j.agent.pojos,2,373,0,373,7,186.5
camel,org.apache.camel.component.jms.integration,4,234,139,373,39,93.25
camel,org.apache.camel.dataformat.bindy.fixed.link,16,319,53,372,2,23.25
camel,generated.java.org.apache.camel.component.google.pubsub,2,0,372,372,4,186.0
camel,org.apache.camel.impl.saga,6,362,10,372,5,62.0
camel,org.apache.camel.dataformat.bindy.fixed.converter,10,320,52,372,1,37.2
camel,org.apache.camel.language.simple.types,24,245,126,371,25,15.458333333333334
camel,org.apache.camel.itest.customerrelations,22,276,94,370,3,16.818181818181817
camel,test.java.org.apache.camel.component.caffeine.lrucache,1,0,370,370,2,370.0
camel,test.java.org.apache.camel.commands.jolokia,1,0,368,368,2,368.0
camel,org.apache.camel.dataformat.dfdl,4,356,12,368,3,92.0
camel,generated.java.org.apache.camel.component.jbpm,1,0,368,368,3,368.0
camel,test.java.org.apache.camel.processor.intercept,5,0,368,368,5,73.6
camel,org.apache.camel.examples.grpc,10,184,184,368,2,36.8
camel,generated.java.org.apache.camel.component.aws.firehose,2,0,367,367,3,183.5
camel,org.apache.camel.component.aws2.athena.client.impl,6,347,20,367,4,61.166666666666664
camel,test.java.org.apache.camel.component.aws.s3.integration,2,0,367,367,3,183.5
camel,org.apache.camel.spring.scan,23,208,159,367,9,15.956521739130435
camel,org.apache.camel.jsr356.springboot,2,183,183,366,2,183.0
camel,org.apache.camel.itest.osgi.ftp,16,295,71,366,3,22.875
camel,org.apache.camel.component.ehcache.processor.idempotent,14,328,38,366,3,26.142857142857142
camel,org.apache.camel.component.box2.internal,2,363,3,366,3,183.0
camel,generated.java.org.apache.camel.component.beanstalk,1,0,366,366,3,366.0
camel,com.viwilo.camel.integration,1,365,0,365,2,365.0
camel,org.apache.camel.spring.boot.routefilter,7,337,28,365,7,52.142857142857146
camel,org.apache.camel.component.servicenow.auth,9,267,98,365,4,40.55555555555556
camel,test.java.org.apache.camel.component.kestrel,1,0,365,365,5,365.0
camel,test.java.org.apache.camel.component.ejb,1,0,363,363,7,363.0
camel,org.apache.camel.component.kafka.integration.commit,14,252,111,363,6,25.928571428571427
camel,org.apache.camel.component.djl.model.audio,4,269,94,363,3,90.75
camel,test.java.org.apache.camel.component.azure.storage.datalake.operations,1,0,363,363,3,363.0
camel,org.apache.camel.dataformat.bindy.fixed.ordinal,11,321,42,363,1,33.0
camel,test.java.org.apache.camel.component.soroushbot.support,1,0,362,362,4,362.0
camel,org.apache.camel.commands.internal,6,207,155,362,3,60.333333333333336
camel,org.apache.camel.example.ftp,7,181,181,362,4,51.714285714285715
camel,org.apache.camel.example.bigxml,5,332,30,362,5,72.4
camel,org.apache.camel.dataformat.soap12,13,309,52,361,3,27.76923076923077
camel,test.java.org.apache.camel.itest.osgi.cxf.jaxrs.testbean,1,0,360,360,5,360.0
camel,test.java.org.apache.camel.itest.osgi.jaxb,1,0,360,360,5,360.0
camel,org.apache.camel.component.pinecone.it,9,308,51,359,3,39.888888888888886
camel,test.java.org.apache.camel.component.atomix.client.multimap,1,0,359,359,1,359.0
camel,org.apache.camel.component.ahc.javabody,11,314,44,358,2,32.54545454545455
camel,org.apache.camel.component.aws2.sts.localstack,9,306,52,358,5,39.77777777777778
camel,test.java.org.apache.camel.dataformat.tagsoup,1,0,358,358,5,358.0
camel,test.java.org.apache.camel.websocket.jsr356,1,0,358,358,4,358.0
camel,generated.java.org.apache.camel.component.jclouds,1,0,358,358,4,358.0
camel,test.java.org.apache.camel.component.aws.sdb.integration,2,0,358,358,2,179.0
camel,org.apache.camel.component.elasticsearch.rest.client.integration,5,351,6,357,4,71.4
camel,test.java.org.apache.camel.spring.model,2,0,357,357,4,178.5
camel,org.apache.camel.component.everit.jsonschema.springboot,2,178,178,356,4,178.0
camel,org.apache.camel.component.kafka.consumer.support.streaming,3,312,44,356,2,118.66666666666667
camel,org.apache.camel.component.firebase.exception,6,178,178,356,2,59.333333333333336
camel,test.java.org.apache.camel.itest.greeter,1,0,355,355,7,355.0
camel,test.java.org.apache.camel.component.cometd,2,0,355,355,3,177.5
camel,org.apache.camel.itest.osgi.krati,12,277,78,355,3,29.583333333333332
camel,org.apache.camel.component.influxdb2.data,2,340,14,354,5,177.0
camel,org.apache.camel.component.pg.replication.slot.integration,9,241,113,354,5,39.333333333333336
camel,org.apache.camel.component.hystrix.metrics,11,177,177,354,1,32.18181818181818
camel,test.java.org.apache.camel.component.azure.storage.blob.operations,1,0,354,354,2,354.0
camel,test.java.org.apache.camel.guice.testing,1,0,353,353,4,353.0
camel,test.java.org.apache.camel.component.atomix.client.queue,1,0,353,353,2,353.0
camel,org.apache.camel.spring.javaconfig.autowire,9,303,50,353,5,39.22222222222222
camel,test.java.org.apache.camel.component.couchdb,2,0,353,353,4,176.5
camel,org.apache.camel.component.list,14,313,40,353,4,25.214285714285715
camel,org.apache.camel.component.ibm.watson.language.integration,1,353,0,353,2,353.0
camel,org.apache.camel.component.aws2.eventbridge.integration,16,295,57,352,4,22.0
camel,org.apache.camel.component.salesforce.internal.pubsub,4,297,55,352,3,88.0
camel,org.apache.camel.service.lra.springboot,5,176,176,352,2,70.4
camel,org.apache.camel.component.kubernetes.cluster.lock.impl,5,331,21,352,2,70.4
camel,org.apache.camel.component.aws.lambda.integration,8,319,32,351,2,43.875
camel,org.apache.camel.component.kserve.it,1,351,0,351,2,351.0
camel,org.apache.camel.component.dns.cloud,14,286,65,351,4,25.071428571428573
camel,org.apache.camel.test.infra.keycloak.services,2,351,0,351,5,175.5
camel,test.java.org.apache.camel.itest.osgi.sql,1,0,351,351,3,351.0
camel,org.apache.camel.component.openshift.build_configs.springboot,9,85,265,350,2,38.888888888888886
camel,org.apache.camel.component.cassandra.integration,12,229,121,350,6,29.166666666666668
camel,org.apache.camel.spring.rmi,4,300,50,350,1,87.5
camel,org.apache.camel.component.debezium.oracle.configuration,8,315,35,350,2,43.75
camel,org.apache.camel.reactive.tomcat,3,320,30,350,1,116.66666666666667
camel,org.apache.camel.component.knative.ce,9,333,16,349,3,38.77777777777778
camel,generated.java.org.apache.camel.component.aws.ddb,1,0,349,349,3,349.0
camel,test.java.org.apache.camel.component.google.storage.unit,1,0,349,349,4,349.0
camel,test.java.org.apache.camel.component.seda,4,0,349,349,4,87.25
camel,org.apache.camel.component.aws.s3.client,9,174,174,348,6,38.666666666666664
camel,test.java.org.apache.camel.component.etcd.integration,1,0,348,348,3,348.0
camel,org.apache.camel.component.yql.client,5,174,174,348,2,69.6
camel,org.apache.camel.itest.osgi.http,10,310,37,347,2,34.7
camel,org.apache.camel.component.google.secret.manager.vault,11,300,47,347,1,31.545454545454547
camel,test.java.org.apache.camel.component.gae.login,2,0,346,346,7,173.0
camel,test.java.org.apache.camel.builder.endpoint,3,0,346,346,4,115.33333333333333
camel,generated.java.org.apache.camel.component.azure.storage.queue,1,0,345,345,3,345.0
camel,org.apache.camel.language.java,1,344,0,344,3,344.0
camel,org.apache.camel.component.weather.http,6,172,172,344,4,57.333333333333336
camel,org.apache.camel.component.workday.auth,6,245,98,343,3,57.166666666666664
camel,org.apache.camel.cdi.store,5,270,71,341,3,68.2
camel,generated.java.org.apache.camel.component.sjms.batch,1,0,341,341,3,341.0
camel,org.apache.camel.component.torchserve.client.impl,2,341,0,341,3,170.5
camel,org.apache.camel.language.js,6,327,14,341,6,56.833333333333336
camel,org.apache.camel.component.hdfs2.integration,9,305,36,341,4,37.888888888888886
camel,org.apache.camel.component.quickfixj.converter,19,296,43,339,2,17.842105263157894
camel,org.apache.camel.example.springboot.grpc,9,169,169,338,4,37.55555555555556
camel,org.apache.camel.component.spring.integration.converter,27,197,141,338,2,12.518518518518519
camel,org.apache.camel.component.kubernetes.secrets.vault,5,323,14,337,2,67.4
camel,generated.java.org.apache.camel.component.aws.ses,1,0,337,337,3,337.0
camel,org.apache.camel.component.kubernetes.consumer.integration.replication_controllers,1,336,0,336,5,336.0
camel,org.apache.camel.component.kubernetes.consumer.integration.deployments,1,336,0,336,5,336.0
camel,generated.java.org.apache.camel.component.elasticsearch,1,0,335,335,3,335.0
camel,org.apache.camel.component.openshift.builds.springboot,8,78,257,335,2,41.875
camel,org.apache.camel.component.spring.cloud.config,1,335,0,335,4,335.0
camel,org.apache.camel.example.cdi.kubernetes,14,167,167,334,1,23.857142857142858
camel,org.apache.camel.component.kubernetes.consumer.integration.pods,1,334,0,334,5,334.0
camel,test.java.org.apache.camel.processor.cache,1,0,334,334,3,334.0
camel,org.apache.camel.dynamicep,2,167,167,334,3,167.0
camel,org.apache.camel.component.zookeepermaster.policy,11,311,23,334,1,30.363636363636363
camel,test.java.org.apache.camel.jmxconnect,1,0,334,334,4,334.0
camel,org.apache.camel.saga,16,244,89,333,8,20.8125
camel,org.apache.camel.component.netty4.ssl,8,209,123,332,1,41.5
camel,test.java.org.apache.camel.test.blueprint.management,1,0,332,332,5,332.0
camel,org.apache.camel.spring.javaconfig.patterns,19,251,80,331,3,17.42105263157895
camel,org.apache.camel.component.twitter.consumer.search,15,229,102,331,1,22.066666666666666
camel,org.apache.camel.component.aws2.sns.localstack,9,277,54,331,4,36.77777777777778
camel,org.apache.camel.rest.model,14,282,48,330,8,23.571428571428573
camel,org.apache.camel.component.cxf.ssl,21,264,66,330,4,15.714285714285714
camel,org.apache.camel.example.ehcache,3,165,165,330,3,110.0
camel,org.apache.camel.dataformat.bindy.model.fix.withoutsection,6,217,113,330,1,55.0
camel,org.apache.camel.component.aws2.sts.client.impl,7,316,14,330,3,47.142857142857146
camel,org.apache.camel.spring.boot.mockendpoints,11,286,44,330,4,30.0
camel,org.apache.camel.component.wordpress.api.service,5,313,16,329,10,65.8
camel,org.apache.camel.itest.osgi.cache.replication,8,297,32,329,3,41.125
camel,test.java.org.apache.camel.itest.osgi.jpa,1,0,328,328,4,328.0
camel,test.java.org.apache.camel.component.reactive.streams.springboot.test,1,0,328,328,4,328.0
camel,org.apache.camel.component.fury,2,314,14,328,4,164.0
camel,org.apache.camel.dataformat.bindy.fixed.skipfields,11,289,38,327,1,29.727272727272727
camel,org.apache.camel.dataformat.hl7,10,298,29,327,3,32.7
camel,test.java.org.apache.camel.component.jms.remoting,3,0,327,327,7,109.0
camel,generated.java.org.apache.camel.component.resteasy,1,0,327,327,3,327.0
camel,org.apache.camel.dataformat.bindy.classtype,10,291,36,327,2,32.7
camel,generated.java.org.apache.camel.converter.jaxp,1,0,327,327,4,327.0
camel,generated.resources.org.apache.camel.converter.jaxp,1,0,327,327,4,327.0
camel,org.apache.camel.component.vertx.kafka.offset,2,163,163,326,8,163.0
camel,org.apache.camel.itest.quartz,18,278,48,326,3,18.11111111111111
camel,test.java.org.apache.camel.component.jcr,3,0,325,325,3,108.33333333333333
camel,org.apache.camel.component.jgroups.cluster,16,54,271,325,3,20.3125
camel,test.java.org.apache.camel.component.aws.s3.client.impl,2,0,325,325,4,162.5
camel,test.java.org.apache.camel.component.atomix.client.set,1,0,324,324,2,324.0
camel,org.apache.camel.maven.component.vertx.kafka,2,162,162,324,2,162.0
camel,org.apache.camel.example.springboot.geocoder,9,189,135,324,4,36.0
camel,test.java.org.apache.camel.maven.packaging.dsl.component,1,0,323,323,5,323.0
camel,org.apache.camel.component.jgroups.ha,2,322,1,323,3,161.5
camel,org.apache.camel.test.infra.torchserve.services,8,301,22,323,7,40.375
camel,org.apache.camel.dataformat.lzf,17,285,38,323,3,19.0
camel,test.java.org.apache.camel.component.google.secret.manager.integration,1,0,323,323,1,323.0
camel,generated.java.org.apache.camel.component.aws.translate,1,0,323,323,3,323.0
camel,org.apache.camel.spring.cloud.processor.remote,1,322,0,322,4,322.0
camel,org.apache.camel.oauth.jakarta,3,315,7,322,2,107.33333333333333
camel,org.apache.camel.component.urlrewrite.jetty,6,301,20,321,4,53.5
camel,org.apache.camel.itest.osgi.bean.validator,6,269,51,320,5,53.333333333333336
camel,test.java.org.apache.camel.component.ribbon.springboot.cloud,2,0,320,320,4,160.0
camel,org.apache.camel.component.kamelet.utils.mongodb,2,320,0,320,1,160.0
camel,generated.java.org.apache.camel.component.soroushbot.component,1,0,320,320,3,320.0
camel,test.java.org.apache.camel.component.jsonvalidator,2,0,319,319,5,159.5
camel,org.apache.camel.component.aws.kinesis.integration,13,258,61,319,2,24.53846153846154
camel,test.java.org.apache.camel.itest.osgi.cache,1,0,319,319,3,319.0
camel,org.apache.camel.component.bar,10,287,32,319,10,31.9
camel,org.apache.camel.component.cxf.wsa,18,253,66,319,4,17.72222222222222
camel,org.apache.camel.example.cxf.ws,5,159,159,318,4,63.6
camel,org.apache.camel.component.jms.polling,1,318,0,318,5,318.0
camel,org.apache.camel.component.thrift.impl,8,251,67,318,2,39.75
camel,test.java.org.apache.camel.component,3,0,318,318,4,106.0
camel,org.apache.camel.component.milvus.it,5,305,13,318,2,63.6
camel,org.apache.camel.component.osgi.activator,8,309,8,317,2,39.625
camel,org.apache.camel.component.infinispan.remote.embeddingstore,2,313,4,317,4,158.5
camel,test.java.org.apache.camel.example.cafe,1,0,317,317,4,317.0
camel,org.apache.camel.component.workday.producer,7,237,79,316,3,45.142857142857146
camel,org.apache.camel.component.kubernetes.config_maps.vault,5,312,4,316,2,63.2
camel,org.apache.camel.component.mongodb3.processor.idempotent,8,280,36,316,2,39.5
camel,test.java.org.apache.camel.example,3,0,316,316,5,105.33333333333333
camel,generated.java.org.apache.camel.component.apns,1,0,315,315,3,315.0
camel,org.apache.camel.test.infra.weaviate.services,3,311,4,315,5,105.0
camel,generated.java.org.apache.camel.component.hipchat,1,0,315,315,3,315.0
camel,org.apache.camel.dataformat.bindy.fixed.ignoretrailing,9,284,31,315,1,35.0
camel,test.java.org.apache.camel.component.linkedin.api,1,0,315,315,3,315.0
camel,org.apache.camel.test.infra.chatscript.services,13,272,42,314,7,24.153846153846153
camel,org.apache.camel.component.geocoder.http,5,170,144,314,4,62.8
camel,org.apache.camel.web,13,162,152,314,2,24.153846153846153
camel,org.apache.camel.foo.bar,9,245,68,313,2,34.77777777777778
camel,org.apache.camel.component.huaweicloud.smn.constants,4,272,40,312,8,78.0
camel,org.apache.camel.component.google.functions.mock,2,290,22,312,1,156.0
camel,generated.java.org.apache.camel.component.azure.queue,1,0,311,311,3,311.0
camel,org.apache.camel.dsl.jbang.core.commands.jolokia,1,311,0,311,3,311.0
camel,org.apache.camel.component.torchserve.client,1,311,0,311,4,311.0
camel,test.java.org.apache.camel.builder.script.example,2,0,311,311,7,155.5
camel,org.apache.camel.cdi.pojo,3,195,115,310,5,103.33333333333333
camel,org.apache.camel.guice.util,2,155,155,310,3,155.0
camel,generated.java.org.apache.camel.component.gora,1,0,310,310,3,310.0
camel,test.java.org.apache.camel.component.spring.integration,1,0,310,310,7,310.0
camel,org.apache.camel.component.dropbox.validator,14,211,98,309,1,22.071428571428573
camel,test.java.org.apache.camel.spring.boot.routefilter,2,0,309,309,7,154.5
camel,org.apache.camel.component.dozer.example.xyz,7,266,42,308,2,44.0
camel,org.apache.camel.component.firebase.data,6,154,154,308,2,51.333333333333336
camel,org.apache.camel.component.minio.client,3,154,154,308,3,102.66666666666667
camel,org.apache.camel.component.uface.swing,6,154,154,308,8,51.333333333333336
camel,org.apache.camel.example.cdi.two,9,264,43,307,3,34.111111111111114
camel,org.apache.camel.component.consul.processor.remote,3,123,184,307,6,102.33333333333333
camel,org.apache.camel.component.undertow.cloud,15,265,42,307,4,20.466666666666665
camel,test.java.org.apache.camel.component.undertow,2,0,307,307,3,153.5
camel,org.apache.camel.component.netty.ssl,11,154,152,306,1,27.818181818181817
camel,org.apache.camel.component.aws2.s3.transform,6,250,56,306,3,51.0
camel,generated.java.org.apache.camel.component.aws.cw,1,0,305,305,3,305.0
camel,org.apache.camel.example.kubernetes.fmp,8,152,152,304,3,38.0
camel,generated.java.org.apache.camel.component.ahc,1,0,304,304,3,304.0
camel,org.apache.camel.example.metrics.cdi,4,296,8,304,5,76.0
camel,org.apache.camel.component.jbpm.emitters,4,152,152,304,2,76.0
camel,org.apache.camel.jmxconnect.provider.activemq,4,152,152,304,3,76.0
camel,org.apache.camel.example.jmx,7,152,152,304,3,43.42857142857143
camel,org.apache.camel.component.docling.integration,2,303,1,304,2,152.0
camel,org.apache.camel.management.util,4,181,123,304,2,76.0
camel,org.apache.camel.component.jgroups.raft.springboot.cluster.springboot,5,152,152,304,2,60.8
camel,org.apache.camel.example.bam,23,157,146,303,3,13.173913043478262
camel,org.apache.camel.component.atomix.ha.springboot,5,290,13,303,2,60.6
camel,test.java.org.apache.camel.parser.java,1,0,303,303,5,303.0
camel,org.apache.camel.component.aws2.transcribe.client.impl,1,303,0,303,4,303.0
camel,org.apache.camel.component.huaweicloud.obs.models,4,247,55,302,4,75.5
camel,generated.java.org.apache.camel.component.milo.server,1,0,302,302,3,302.0
camel,test.java.org.apache.camel.example.bigxml,1,0,302,302,5,302.0
camel,org.apache.camel.models,2,290,12,302,3,151.0
camel,org.apache.camel.support.processor.validation.helper,2,151,151,302,1,151.0
camel,test.java.org.apache.camel.component.osgi.activator,1,0,301,301,2,301.0
camel,org.apache.camel.processor.dynamicrouter,12,278,23,301,5,25.083333333333332
camel,org.apache.camel.component.spring.ws.jaxb,6,285,16,301,3,50.166666666666664
camel,org.apache.camel.test.infra.nsq.services,2,267,34,301,4,150.5
camel,org.apache.camel.example.mention,9,150,150,300,3,33.333333333333336
camel,org.apache.camel.component.hbase.converter,10,187,113,300,2,30.0
camel,org.apache.camel.component.clickup.util,1,300,0,300,3,300.0
camel,test.java.org.apache.camel.component.aws2.ddbstream,2,0,300,300,3,150.0
camel,test.java.org.apache.camel.component.http4,3,0,300,300,3,100.0
camel,org.apache.camel.support.management,21,157,143,300,4,14.285714285714286
camel,generated.java.org.apache.camel.component.stomp,1,0,299,299,3,299.0
camel,org.apache.camel.component.aws2.redshift.data.client.impl,2,299,0,299,3,149.5
camel,org.apache.camel.component.azure.storage.queue.integration,7,141,158,299,5,42.714285714285715
camel,org.apache.camel.main.uberjar,5,75,223,298,2,59.6
camel,org.apache.camel.dataformat.bindy.fixed.implied,9,259,39,298,1,33.111111111111114
camel,test.java.org.apache.camel.converter.dozer.model,1,0,298,298,4,298.0
camel,test.java.org.apache.camel.component.thrift,1,0,298,298,1,298.0
camel,test.java.org.apache.camel.itest.osgi.cxf,1,0,298,298,5,298.0
camel,org.apache.camel.example.fhir.osgi,6,224,74,298,3,49.666666666666664
camel,org.apache.camel.telemetry.mock,2,296,1,297,3,148.5
camel,org.apache.camel.test.infra.neo4j.services,2,294,3,297,5,148.5
camel,org.apache.camel.component.kubernetes.consumer.integration.configmaps,1,297,0,297,5,297.0
camel,test.java.org.apache.camel.component.apns.util,1,0,297,297,4,297.0
camel,org.apache.camel.loanbroker.webservice.version.bank,5,218,79,297,4,59.4
camel,generated.java.org.apache.camel.component.activemq,1,0,297,297,3,297.0
camel,org.apache.camel.component.jetty.file,19,199,98,297,3,15.631578947368421
camel,org.apache.camel.example.cdi.properties,11,184,113,297,3,27.0
camel,org.apache.camel.component.jms.activemq,20,235,62,297,2,14.85
camel,org.apache.camel.component.kubernetes.consumer.integration.services,1,297,0,297,5,297.0
camel,org.apache.camel.component.micrometer.eventNotifier,13,257,39,296,3,22.76923076923077
camel,org.apache.camel.urlhandler.pd,8,190,106,296,2,37.0
camel,generated.java.org.apache.camel.component.hbase,1,0,296,296,3,296.0
camel,test.java.org.apache.camel.blueprint,2,0,296,296,4,148.0
camel,test.java.org.apache.camel.bam,2,0,294,294,5,147.0
camel,org.apache.camel.example.billboard,11,266,28,294,2,26.727272727272727
camel,org.apache.camel.tests.typeconverterscan,10,251,43,294,4,29.4
camel,generated.java.org.apache.camel.component.ganglia,1,0,293,293,3,293.0
camel,org.apache.camel.component.syslog.netty,12,224,69,293,4,24.416666666666668
camel,org.apache.camel.component.atomix.cluster.springboot,4,8,285,293,2,73.25
camel,org.apache.camel.component.spring.ws.converter,15,207,85,292,3,19.466666666666665
camel,test.java.org.apache.camel.component.azure.storage.blob,1,0,292,292,3,292.0
camel,org.apache.camel.component.cxf.wssecurity.client,11,228,64,292,2,26.545454545454547
camel,org.apache.camel.component.quickfixj.examples.transform,12,246,46,292,3,24.333333333333332
camel,test.java.org.apache.camel.itest.tx,2,0,292,292,2,146.0
camel,org.apache.camel.converter.jaxb.address,8,231,60,291,3,36.375
camel,org.apache.camel.component.metrics.spi,11,242,49,291,2,26.454545454545453
camel,org.apache.camel.component.etcd.support,5,214,77,291,2,58.2
camel,generated.java.org.apache.camel.builder,1,0,290,290,2,290.0
camel,org.apache.camel.dataformat.supercsv,3,177,113,290,2,96.66666666666667
camel,org.apache.camel.component.leveldb.serializer,3,284,6,290,3,96.66666666666667
camel,org.apache.camel.component.atmos.validator,8,145,145,290,1,36.25
camel,test.java.org.apache.camel.component.solr.integration,2,0,290,290,3,145.0
camel,test.java.org.apache.camel.component.jetty.rest.producer,3,0,289,289,5,96.33333333333333
camel,org.apache.camel.component.whatsapp.integration,3,284,5,289,1,96.33333333333333
camel,org.apache.camel.component.clickup.service,2,285,4,289,3,144.5
camel,generated.java.org.apache.camel.component.nsq,1,0,288,288,3,288.0
camel,org.apache.camel.example.pulsar.client,4,144,144,288,2,72.0
camel,test.java.org.apache.camel.dataformat.soap,1,0,288,288,2,288.0
camel,generated.java.org.apache.camel.component.twilio,1,0,288,288,4,288.0
camel,org.apache.camel.component.activemq6.converter,2,284,3,287,4,143.5
camel,org.apache.camel.component.aws2.timestream.client.impl,1,287,0,287,2,287.0
camel,org.apache.camel.component.dropbox.integration,15,205,82,287,1,19.133333333333333
camel,org.apache.camel.component.influxdb.converters,18,251,36,287,3,15.944444444444445
camel,test.java.org.apache.camel.component.aws.lambda.integration,2,0,287,287,2,143.5
camel,org.apache.camel.example.artemis,3,143,143,286,3,95.33333333333333
camel,org.apache.camel.cdi.qualifier,4,201,85,286,3,71.5
camel,test.java.org.apache.camel.component.microprofile.metrics.event.notifier.exchange,2,0,286,286,2,143.0
camel,generated.java.org.apache.camel.component.google.pubsublite,1,0,285,285,3,285.0
camel,org.apache.camel.itest.osgi.script,12,210,75,285,2,23.75
camel,org.apache.camel.component.wordpress.api.test,10,241,44,285,2,28.5
camel,org.apache.camel.component.sjms2.consumer,11,226,59,285,2,25.90909090909091
camel,generated.java.org.apache.camel.component.aws.lambda,1,0,284,284,3,284.0
camel,test.java.org.apache.camel.component.snmp,2,0,284,284,4,142.0
camel,generated.java.org.apache.camel.component.aws.ec2,1,0,284,284,3,284.0
camel,generated.java.org.apache.camel.component.aws.ecs,1,0,284,284,3,284.0
camel,org.apache.camel.example.pulsar.server,5,142,142,284,4,56.8
camel,generated.java.org.apache.camel.component.aws.eks,1,0,284,284,3,284.0
camel,generated.java.org.apache.camel.component.aws.msk,1,0,284,284,3,284.0
camel,generated.java.org.apache.camel.component.aws.kms,1,0,284,284,3,284.0
camel,generated.java.org.apache.camel.component.aws.iam,1,0,284,284,3,284.0
camel,generated.java.org.apache.camel.component.aws.mq,1,0,284,284,3,284.0
camel,org.apache.camel.component.jmx.beans,10,251,32,283,3,28.3
camel,org.apache.camel.dataformat.bindy.fixed.unmarshall.simple,4,249,34,283,2,70.75
camel,test.java.org.apache.camel.component.dropbox.integration.producer,1,0,283,283,3,283.0
camel,test.java.org.apache.camel.component.xmlsecurity,1,0,283,283,1,283.0
camel,org.apache.camel.component.ibm.secrets.manager.vault,2,278,4,282,1,141.0
camel,org.apache.camel.dsl.groovy,5,107,175,282,2,56.4
camel,org.apache.camel.component.sjms2.jms,6,254,28,282,1,47.0
camel,test.java.org.apache.camel.itest.jms2,1,0,282,282,3,282.0
camel,org.apache.camel.component.kubernetes.consumer.integration.events,1,281,0,281,5,281.0
camel,test.java.org.apache.camel.component.docker,2,0,281,281,3,140.5
camel,test.java.org.apache.camel.dataformat.swift.mx,1,0,281,281,2,281.0
camel,org.apache.camel.groovy,2,225,56,281,5,140.5
camel,org.apache.camel.dataformat.bindy.model.complex.generateheader,5,260,21,281,3,56.2
camel,test.java.org.apache.camel.component.urlrewrite.jetty,1,0,281,281,4,281.0
camel,org.apache.camel.component.huaweicloud.obs.constants,9,276,4,280,8,31.11111111111111
camel,.mvn.wrapper,4,140,140,280,1,70.0
camel,generated.java.org.apache.camel.component.google.sheets.internal,1,0,280,280,4,280.0
camel,generated.java.org.apache.camel.component.weka,1,0,279,279,4,279.0
camel,org.apache.camel.component.google.functions.integration,6,273,6,279,3,46.5
camel,test.java.org.apache.camel.model,2,0,279,279,2,139.5
camel,org.apache.camel.test.infra.ignite.services,9,251,28,279,7,31.0
camel,test.java.org.apache.camel.component.infinispan.remote,3,0,279,279,3,93.0
camel,test.java.org.apache.camel.component.dynamicrouter.support,1,0,279,279,1,279.0
camel,org.apache.camel.component.ribbon,5,139,139,278,2,55.6
camel,org.apache.camel.component.debezium.oracle,6,258,20,278,5,46.333333333333336
camel,org.foo.connector,6,139,139,278,4,46.333333333333336
camel,org.apache.camel.component.weather.geolocation,15,207,71,278,3,18.533333333333335
camel,generated.java.org.apache.camel.component.crypto.cms,1,0,277,277,3,277.0
camel,org.apache.camel.dataformat.bindy.model.date,13,253,24,277,1,21.307692307692307
camel,org.apache.camel.component.wordpress.consumer,9,251,26,277,3,30.77777777777778
camel,org.apache.camel.component.kubernetes.springboot.cluster,4,8,269,277,2,69.25
camel,generated.java.org.apache.camel.component.atmos,1,0,276,276,3,276.0
camel,org.apache.camel.test.infra.aws2.common,3,244,32,276,6,92.0
camel,test.java.org.apache.camel.spring.javaconfig.patterns,4,0,275,275,3,68.75
camel,org.apache.camel.itest.osgi.hazelcast,6,238,37,275,2,45.833333333333336
camel,test.java.org.apache.camel.component.jetty.rest,3,0,275,275,3,91.66666666666667
camel,org.apache.camel.component.influxdb2.converters,4,270,4,274,4,68.5
camel,test.java.org.apache.camel.component.yql,1,0,273,273,2,273.0
camel,org.apache.camel.language.xquery,20,161,112,273,1,13.65
camel,org.apache.camel.component.kubernetes.consumer.integration.hpa,1,273,0,273,5,273.0
camel,org.apache.camel.spring.boot.cluster,4,13,260,273,2,68.25
camel,test.java.org.apache.camel.component.spark,1,0,273,273,1,273.0
camel,test.java.org.apache.camel.itest.osgi.http,1,0,273,273,2,273.0
camel,test.java.org.apache.camel.component.grpc,1,0,272,272,1,272.0
camel,org.apache.camel.itest.osgi.protobuf,14,194,78,272,1,19.428571428571427
camel,org.apache.camel.component.sjms.threadpool,10,195,77,272,1,27.2
camel,main.resources.archetype-resources.__artifactId__-component.src.test.java,7,165,107,272,2,38.857142857142854
camel,test.java.org.apache.camel.core.osgi.test,1,0,271,271,4,271.0
camel,org.apache.camel.component.zookeeper.cluster.springboot,3,135,135,270,2,90.0
camel,org.apache.camel.spring.pollingconsumer,16,230,40,270,3,16.875
camel,test.java.org.apache.camel.dataformat.bindy.fixed.marshall.simple,1,0,270,270,1,270.0
camel,test.java.org.apache.camel.component.ahc.javabody,1,0,270,270,2,270.0
camel,org.apache.camel.console,12,256,13,269,3,22.416666666666668
camel,org.apache.camel.component.debezium.postgres.configuration,6,263,6,269,2,44.833333333333336
camel,org.apache.camel.component.aws.ddb.integration,12,244,25,269,2,22.416666666666668
camel,org.apache.camel.pgevent.integration,14,220,49,269,6,19.214285714285715
camel,test.java.org.apache.camel.jaxb,3,0,269,269,4,89.66666666666667
camel,test.java.org.apache.camel.component.swagger,2,0,268,268,4,134.0
camel,test.java.org.apache.camel.component.hdfs.kerberos,3,0,268,268,4,89.33333333333333
camel,org.apache.camel.component.langchain4j.tools.integration,3,250,18,268,6,89.33333333333333
camel,org.apache.camel.component.hazelcast.replicatedmap.springboot.customizer,5,134,134,268,2,53.6
camel,org.apache.camel.component.hazelcast.ringbuffer.springboot.customizer,5,134,134,268,2,53.6
camel,org.apache.camel.component.hazelcast.topic.springboot.customizer,5,134,134,268,2,53.6
camel,org.apache.camel.component.hazelcast.seda.springboot.customizer,5,134,134,268,2,53.6
camel,org.apache.camel.component.hazelcast.atomicnumber.springboot.customizer,5,134,134,268,2,53.6
camel,test.java.org.apache.camel.impl.model,2,0,268,268,2,134.0
camel,org.apache.camel.component.hazelcast.list.springboot.customizer,5,134,134,268,2,53.6
camel,org.apache.camel.component.hazelcast.instance.springboot.customizer,5,134,134,268,2,53.6
camel,org.apache.camel.component.hazelcast.map.springboot.customizer,5,134,134,268,2,53.6
camel,org.apache.camel.component.hazelcast.multimap.springboot.customizer,5,134,134,268,2,53.6
camel,org.apache.camel.component.hazelcast.set.springboot.customizer,5,134,134,268,2,53.6
camel,org.apache.camel.component.hazelcast.queue.springboot.customizer,5,134,134,268,2,53.6
camel,test.java.org.apache.camel.component.cxf.transport,3,0,268,268,5,89.33333333333333
camel,org.apache.camel.component.kubernetes.springboot.ha,2,264,3,267,2,133.5
camel,test.java.org.apache.camel.component.facebook.data,1,0,267,267,3,267.0
camel,org.apache.camel.test.infra.aws.common,4,236,31,267,6,66.75
camel,org.apache.camel.test.infra.jdbc.services,5,250,17,267,5,53.4
camel,org.apache.camel.component.huaweicloud.smn.models,3,202,64,266,4,88.66666666666667
camel,test.java.org.apache.camel.itest.osgi.cache.replication,1,0,265,265,3,265.0
camel,test.java.org.apache.camel.component.azure.key.vault.integration.operations,1,0,265,265,1,265.0
camel,org.apache.camel.spring.placeholder,17,194,71,265,5,15.588235294117647
camel,org.apache.camel.swagger.component.springboot,3,132,132,264,2,88.0
camel,org.apache.camel.builder.zip,1,264,0,264,4,264.0
camel,org.apache.camel.component.dapr.consumer,2,251,12,263,4,131.5
camel,generated.java.org.apache.camel.component.cmis,1,0,263,263,3,263.0
camel,test.java.org.apache.camel.view,1,0,263,263,4,263.0
camel,test.java.org.apache.camel.itest.osgi.jetty,1,0,263,263,4,263.0
camel,test.java.org.apache.camel.component.aws2.ddb,3,0,262,262,3,87.33333333333333
camel,org.example.server,1,262,0,262,5,262.0
camel,org.apache.camel.component.aws.config.integration,6,258,4,262,3,43.666666666666664
camel,test.java.org.apache.camel.web.resources,1,0,262,262,5,262.0
camel,org.apache.camel.test.infra.docling.services,1,262,0,262,5,262.0
camel,test.java.org.apache.camel.catalog.rest,1,0,261,261,3,261.0
camel,test.java.org.apache.camel.component.boon,1,0,261,261,3,261.0
camel,org.apache.camel.spring.converter,14,244,17,261,5,18.642857142857142
camel,org.apache.camel.web.htmlunit,10,229,32,261,2,26.1
camel,org.apache.camel.language.ref,18,196,64,260,4,14.444444444444445
camel,org.apache.camel.example.management,17,160,100,260,2,15.294117647058824
camel,org.apache.camel.component.routebox.demo,6,240,20,260,4,43.333333333333336
camel,generated.java.org.apache.camel.component.rest.swagger,1,0,260,260,3,260.0
camel,test.java.org.apache.camel.model.dataformat,3,0,259,259,4,86.33333333333333
camel,test.java.org.apache.camel.itest.osgi,1,0,258,258,2,258.0
camel,org.apache.camel.example.telegram,5,129,129,258,3,51.6
camel,org.apache.camel.test.infra.etcd.services,2,233,24,257,4,128.5
camel,org.apache.camel.component.kubernetes.consumer.integration.support,1,256,0,256,1,256.0
camel,org.apache.camel.maven.packaging.dsl,10,159,97,256,1,25.6
camel,test.java.org.apache.camel.test.infra.solr.services,2,0,256,256,5,128.0
camel,org.apache.camel.loanbroker.webservice.version.credit,7,160,96,256,4,36.57142857142857
camel,org.jvnet.mock_javamail.provider,6,128,128,256,6,42.666666666666664
camel,org.apache.camel.processor.interceptor.jpa,8,33,223,256,1,32.0
camel,org.apache.camel.component.aws.sns.integration,9,228,28,256,3,28.444444444444443
camel,org.apache.camel.spring.boot.ha,3,251,4,255,2,85.0
camel,test.java.org.apache.camel.component.infinispan.processor.idempotent,1,0,255,255,3,255.0
camel,org.apache.camel.component.master.util,1,255,0,255,3,255.0
camel,org.apache.camel.example.docs,9,143,112,255,4,28.333333333333332
camel,test.java.org.apache.camel.component.rabbitmq.integration.qpid,1,0,255,255,9,255.0
camel,test.java.org.apache.camel.component.master.util,1,0,255,255,3,255.0
camel,test.java.org.apache.camel.component.firebase,1,0,255,255,3,255.0
camel,org.apache.camel.component.soroushbot.models.response,4,127,127,254,3,63.5
camel,test.java.org.apache.camel.spring.javaconfig.autowire,1,0,253,253,5,253.0
camel,test.java.org.apache.camel.component.google.mail.stream,2,0,253,253,4,126.5
camel,org.apache.camel.dsl.jbang.core.templates,4,126,126,252,1,63.0
camel,org.apache.camel.component.debezium.postgres,6,232,20,252,5,42.0
camel,org.apache.camel.component.twitter.consumer.trends,2,126,126,252,2,126.0
camel,org.apache.camel.rest.util,11,179,73,252,4,22.90909090909091
camel,test.java.org.apache.camel.test.infra.hbase.services,1,0,252,252,4,252.0
camel,org.apache.camel.component.linkedin.internal,7,126,126,252,3,36.0
camel,org.apache.camel.component.kafka.consumer.devconsole,1,251,0,251,3,251.0
camel,test.java.org.apache.camel.spring.cloud.zookeeper,1,0,251,251,2,251.0
camel,test.java.org.apache.camel.component.kubernetes.consumer,2,0,251,251,2,125.5
camel,test.java.org.apache.camel.itest.osgi.core.log,1,0,251,251,3,251.0
camel,org.apache.camel.itest.osgi.xstream,9,220,31,251,3,27.88888888888889
camel,org.apache.camel.spring.patterns,14,234,17,251,3,17.928571428571427
camel,test.java.org.apache.camel.spring.example,1,0,251,251,4,251.0
camel,org.apache.camel.test.infra.ftp.services,8,200,50,250,5,31.25
camel,test.java.org.apache.camel.processor.jpa,1,0,250,250,2,250.0
camel,org.apache.camel.test.infra.triton.services,1,250,0,250,5,250.0
camel,test.java.org.apache.camel.component.pulsar,2,0,250,250,2,125.0
camel,org.apache.camel.component.pulsar.utils.message,13,232,18,250,3,19.23076923076923
camel,test.java.org.apache.camel.test.junit5,1,0,250,250,4,250.0
camel,test.java.org.apache.camel.component.activemq.converter,1,0,249,249,3,249.0
camel,test.java.org.apache.camel.component.jackson,4,0,249,249,4,62.25
camel,org.apache.camel.dataformat.bindy.model.simple.onetomany,3,183,66,249,2,83.0
camel,org.apache.camel.itest.osgi.mybatis,8,215,34,249,2,31.125
camel,org.apache.camel.component.github.services,17,194,55,249,5,14.647058823529411
camel,org.apache.camel.component.jetty.cloud,5,161,88,249,4,49.8
camel,org.apache.camel.component.wordpress.api,7,230,18,248,3,35.42857142857143
camel,org.apache.camel.component.http4.rest,5,213,35,248,2,49.6
camel,org.apache.camel.component.cmis.exception,3,124,124,248,3,82.66666666666667
camel,org.apache.camel.language.script,17,202,46,248,4,14.588235294117647
camel,org.apache.camel.component.jsonb.converter,2,190,58,248,3,124.0
camel,org.apache.camel.component.johnzon.converter,2,190,58,248,3,124.0
camel,test.java.org.apache.camel.processor.onexception,3,0,248,248,3,82.66666666666667
camel,org.apache.camel.dataformat.bindy.model.simple.oneclassdifferentposition,8,204,43,247,1,30.875
camel,generated.java.org.apache.camel.component.directvm,1,0,247,247,3,247.0
camel,org.apache.camel.spring.boot.actuate.info,3,150,97,247,3,82.33333333333333
camel,org.apache.camel.itest.validator,8,200,47,247,1,30.875
camel,org.apache.camel.test.mllp,7,188,59,247,3,35.285714285714285
camel,org.apache.camel.dataformat.bindy.model.car,5,240,7,247,1,49.4
camel,org.apache.camel.component.zookeeper.cloud.integration,11,124,122,246,8,22.363636363636363
camel,test.java.org.apache.camel.spring.issues,4,0,245,245,5,61.25
camel,org.apache.camel.dataformat.flatpack,20,188,57,245,2,12.25
camel,org.apache.camel.example.pojo_messaging,16,192,53,245,3,15.3125
camel,test.java.org.apache.camel.itest.osgi.hl7,1,0,243,243,3,243.0
camel,org.apache.camel.component.debezium.mysql.configuration,7,217,26,243,2,34.714285714285715
camel,test.java.org.apache.camel.itest.osgi.jclouds,2,0,243,243,3,121.5
camel,org.apache.camel.component.reactive.streams.platforms,9,224,18,242,4,26.88888888888889
camel,test.java.org.apache.camel.spring.boot.mockendpoints,1,0,242,242,4,242.0
camel,org.apache.camel.component.consul.springboot.health,3,121,121,242,2,80.66666666666667
camel,org.apache.camel.dataformat.any23.utils,8,121,121,242,1,30.25
camel,test.java.org.apache.camel.component.nsq.integration,1,0,242,242,3,242.0
camel,org.apache.camel.dsl.jbang.core.commands.kamelet,1,241,0,241,2,241.0
camel,org.apache.camel.component.bonita.api.filter,8,183,58,241,2,30.125
camel,org.apache.camel.itest.osgi.beanio,3,236,5,241,2,80.33333333333333
camel,test.java.org.apache.camel.component.pubnub,1,0,241,241,2,241.0
camel,org.apache.camel.component.sql.stored.template,11,155,86,241,3,21.90909090909091
camel,org.apache.camel.test.infra.artemis.common,6,234,7,241,4,40.166666666666664
camel,org.apache.camel.component.sjms.typeconversion,4,221,20,241,1,60.25
camel,main.resources.archetype-resources.src.main.java.internal,9,120,120,240,2,26.666666666666668
camel,org.apache.camel.itest.netty,19,182,58,240,1,12.631578947368421
camel,org.apache.camel.cdi.routetemplate,3,233,7,240,5,80.0
camel,org.apache.camel.component.cxf.spring.jaxws,9,187,52,239,4,26.555555555555557
camel,org.apache.camel.component.azure.storage.datalake.component,9,221,18,239,2,26.555555555555557
camel,test.java.org.apache.camel.component.mail,4,0,239,239,4,59.75
camel,org.apache.camel.component.quartz.cron,6,214,25,239,3,39.833333333333336
camel,org.apache.camel.itest.osgi.file,2,180,59,239,3,119.5
camel,org.apache.camel.component.jcache.osgi,6,119,119,238,1,39.666666666666664
camel,org.apache.camel.component.aws2.bedrock.integration,7,211,27,238,1,34.0
camel,test.java.org.apache.camel.itest.issues,2,0,238,238,3,119.0
camel,test.java.org.apache.camel.example.billboard,1,0,238,238,2,238.0
camel,test.java.org.apache.camel.component.xmlrpc,1,0,237,237,3,237.0
camel,org.apache.camel.spring.processor.tracing,8,231,6,237,5,29.625
camel,test.java.org.apache.camel.component.atomix.client.value,1,0,236,236,2,236.0
camel,org.apache.camel.dataformat.bindy.fixed.multibytes,5,225,11,236,2,47.2
camel,org.apache.camel.component.fastjson.converter,2,184,52,236,3,118.0
camel,org.apache.camel.itest.idempotent,16,206,30,236,3,14.75
camel,org.apache.camel.example.transformer.demo.client,5,118,118,236,1,47.2
camel,test.java.org.apache.camel.component.jira,1,0,235,235,2,235.0
camel,test.java.org.apache.camel.component.quickfixj,2,0,234,234,2,117.0
camel,org.apache.camel.guice.support.internal,2,117,117,234,2,117.0
camel,org.apache.camel.component.http4.handler,12,178,56,234,14,19.5
camel,org.apache.camel.component.dynamicrouter.message,1,234,0,234,1,234.0
camel,org.apache.camel.component.huaweicloud.frs.models,2,233,0,233,1,116.5
camel,org.apache.camel.itest.jaxb,17,187,46,233,2,13.705882352941176
camel,org.apache.camel.example.cdi.one,9,191,42,233,2,25.88888888888889
camel,test.java.org.apache.camel.test.infra.nsq.services,1,0,233,233,4,233.0
camel,org.apache.camel.example.dsl.java8,2,156,76,232,2,116.0
camel,generated.java.org.apache.camel.component.optaplanner,1,0,232,232,3,232.0
camel,org.apache.camel.test.infra.azure.storage.queue.services,7,208,24,232,5,33.142857142857146
camel,org.apache.camel.test.infra.azure.storage.blob.services,7,208,24,232,5,33.142857142857146
camel,org.apache.camel.itest.osgi.velocity,10,180,52,232,3,23.2
camel,org.apache.camel.pgasync,2,116,116,232,4,116.0
camel,org.apache.camel.component.jms.bind,25,174,57,231,2,9.24
camel,org.apache.camel.component.zookeeper.springboot.cluster,5,95,136,231,3,46.2
camel,test.java.org.apache.camel.itest.osgi.beanio,1,0,231,231,2,231.0
camel,org.apache.camel.spring.mock,20,186,45,231,3,11.55
camel,org.apache.camel.component.hipchat.integration,9,206,25,231,2,25.666666666666668
camel,org.apache.camel.component.http.interceptor,1,215,16,231,5,231.0
camel,generated.java.org.apache.camel.model.cloud,2,0,231,231,2,115.5
camel,test.java.org.apache.camel.component.cassandra,2,0,231,231,3,115.5
camel,org.apache.camel.startup.jfr,10,169,62,231,2,23.1
camel,generated.java.org.apache.camel.component.aws2.ddbstream,2,0,231,231,4,115.5
camel,org.apache.camel.component.headersmap,14,206,24,230,5,16.428571428571427
camel,org.apache.camel.wasm,3,217,13,230,3,76.66666666666667
camel,generated.java.org.apache.camel.component.aws.sdb,1,0,230,230,3,230.0
camel,test.java.org.apache.camel.component.zookeepermaster,1,0,230,230,1,230.0
camel,org.apache.camel.component.elasticsearch.aggregation,9,89,141,230,2,25.555555555555557
camel,org.apache.camel.component.whatsapp.service,2,229,1,230,1,115.0
camel,test.java.org.apache.camel.component.chronicle.engine,1,0,230,230,2,230.0
camel,test.java.org.apache.camel.component.google.sheets.stream,1,0,229,229,2,229.0
camel,test.resources,7,186,43,229,6,32.714285714285715
camel,org.apache.camel.tests.partialclasspath,14,193,36,229,3,16.357142857142858
camel,test.java.org.apache.camel.component.spring.integration.adapter,1,0,228,228,3,228.0
camel,test.java.org.apache.camel.dsl.xml.jaxb.swagger,1,0,228,228,3,228.0
camel,org.apache.camel.component.langchain4j.tools.spec,2,222,6,228,4,114.0
camel,test.java.org.apache.camel.spring.cloud.consul,1,0,228,228,2,228.0
camel,org.apache.camel.component.webhook.support,5,220,8,228,2,45.6
camel,test.java.org.apache.camel.component.milo.server,1,0,228,228,3,228.0
camel,generated.java.org.apache.camel.component.nagios,1,0,228,228,3,228.0
camel,test.java.org.apache.camel.component.as2,2,0,228,228,2,114.0
camel,org.apache.camel.component.aws2.ec2.localstack,6,178,49,227,2,37.833333333333336
camel,generated.java.org.apache.camel.component.atlasmap,1,0,227,227,3,227.0
camel,org.apache.camel.itest.osgi.shiro,11,180,47,227,1,20.636363636363637
camel,org.apache.camel.example.spring,25,128,98,226,2,9.04
camel,org.apache.camel.example.reload,6,113,113,226,3,37.666666666666664
camel,org.apache.camel.loanbroker.bank,7,21,205,226,4,32.285714285714285
camel,test.java.org.apache.camel.cdi.routetemplate,1,0,226,226,5,226.0
camel,org.apache.camel.component.http.rest,12,105,120,225,1,18.75
camel,org.apache.camel.component.debezium.sqlserver.configuration,7,216,9,225,2,32.142857142857146
camel,test.java.org.apache.camel.spring.processor.tracing,1,0,225,225,5,225.0
camel,test.java.org.apache.camel.itest.osgi.ftp,1,0,224,224,3,224.0
camel,org.apache.camel.test.infra.hazelcast.services,4,217,7,224,7,56.0
camel,test.java.org.apache.camel.component.dozer.example.xyz,1,0,224,224,2,224.0
camel,test.java.org.apache.camel.catalog.nexus,1,0,224,224,4,224.0
camel,org.apache.camel.test.infra.hbase.services,4,205,19,224,4,56.0
camel,org.apache.camel.test.infra.cli.it,3,210,14,224,3,74.66666666666667
camel,test.java.org.apache.camel.commands.catalog,1,0,224,224,2,224.0
camel,org.apache.camel.component.kafka.consumer.support.resume,5,194,30,224,3,44.8
camel,test.java.org.apache.camel.runtimecatalog.impl,2,0,223,223,2,111.5
camel,test.java.org.apache.camel.component.ipfs,1,0,223,223,1,223.0
camel,test.java.org.apache.camel.component.netty4.http.springboot,1,0,222,222,3,222.0
camel,org.apache.camel.test.executor,7,202,20,222,3,31.714285714285715
camel,test.java.org.apache.camel.component.http.handler,1,0,222,222,4,222.0
camel,org.apache.camel.component.snakeyaml.model,4,204,18,222,3,55.5
camel,org.apache.camel.main.scan,7,209,13,222,7,31.714285714285715
camel,org.apache.camel.component.infinispan.cluster,3,218,4,222,3,74.0
camel,generated.java.org.apache.camel.component.spring.integration,1,0,221,221,3,221.0
camel,org.apache.camel.component.huaweicloud.dms.constants,4,218,3,221,6,55.25
camel,org.apache.camel.dsl.xml.io.reload,3,213,7,220,1,73.33333333333333
camel,org.apache.camel.component.aws.xray.decorators.internal,3,188,32,220,8,73.33333333333333
camel,org.apache.camel.component.salesforce.internal.joda,2,176,44,220,3,110.0
camel,generated.java.org.apache.camel.component.spark,1,0,220,220,3,220.0
camel,test.java.org.apache.camel.component.routebox.demo,1,0,220,220,4,220.0
camel,org.apache.camel.spring.processor.async,9,214,6,220,6,24.444444444444443
camel,test.java.org.apache.camel.component.sql,3,0,219,219,3,73.0
camel,test.java.org.apache.camel.component.aws.ddb.integration,2,0,219,219,2,109.5
camel,org.apache.camel.model.console,2,218,1,219,1,109.5
camel,test.java.org.apache.camel.spring.cloud.netflix,3,0,219,219,3,73.0
camel,org.apache.camel.test.infra.tensorflow.serving.services,2,215,4,219,4,109.5
camel,org.apache.camel.component.sjms.taskmanager,6,109,109,218,2,36.333333333333336
camel,org.apache.camel.converter.jaxb.message,7,188,30,218,3,31.142857142857142
camel,org.apache.camel.component.krati.serializer,6,109,109,218,1,36.333333333333336
camel,org.apache.camel.component.wordpress.producer,10,203,15,218,3,21.8
camel,test.java.org.apache.camel.itest.osgi.bean.validator,1,0,218,218,5,218.0
camel,org.apache.camel.component.cxf.common,11,167,50,217,11,19.727272727272727
camel,org.apache.camel.itest.shiro,15,154,63,217,1,14.466666666666667
camel,org.apache.camel.component.kafka.consumer.support.classic,4,181,36,217,6,54.25
camel,org.apache.camel.dataformat.bindy.fixed.unmarshall.simple.notrim,2,216,1,217,1,108.5
camel,generated.java.org.apache.camel.component.ahc.ws,1,0,217,217,3,217.0
camel,org.apache.camel.main.app,3,215,1,216,6,72.0
camel,org.apache.camel.openapi.producer,9,188,28,216,3,24.0
camel,org.apache.camel.example.java8.rx,3,108,108,216,1,72.0
camel,org.apache.camel.maven.helper,3,108,108,216,1,72.0
camel,org.apache.camel.component.aws.cw.integration,10,200,15,215,3,21.5
camel,test.java.org.apache.camel.dataformat.bindy.fixed.unmarshall.simple.notrim,1,0,215,215,1,215.0
camel,org.apache.camel.component.jetty12,13,137,78,215,8,16.53846153846154
camel,generated.java.org.apache.camel.component.dozer,1,0,215,215,3,215.0
camel,test.java.org.apache.camel.dataformat.bindy.fixed.unmarshall.simple,1,0,215,215,1,215.0
camel,org.apache.camel.component.extension.metadata,5,206,9,215,6,43.0
camel,generated.java.org.apache.camel.component.influxdb2,1,0,214,214,3,214.0
camel,test.java.org.apache.camel.component.servlet.springboot.test,1,0,214,214,3,214.0
camel,test.java.org.apache.camel.itest.osgi.velocity,1,0,213,213,3,213.0
camel,generated.java.org.apache.camel.websocket.jsr356,1,0,213,213,3,213.0
camel,org.apache.camel.component.langchain4j.tokenizer.util,2,197,16,213,3,106.5
camel,org.apache.camel.component.debezium.sqlserver,6,193,20,213,5,35.5
camel,org.apache.camel.component.rabbitmq.testbeans,7,206,7,213,4,30.428571428571427
camel,test.java.org.apache.camel.converter.jaxb,2,0,212,212,2,106.0
camel,test.java.org.apache.camel.component.jdbc,3,0,212,212,3,70.66666666666667
camel,generated.java.org.apache.camel.component.google.bigquery,1,0,212,212,3,212.0
camel,org.apache.camel.examples.master,4,106,106,212,2,53.0
camel,org.apache.camel.itest.spring2,4,210,2,212,3,53.0
camel,org.apache.camel.component.aws2.s3.utils,13,194,18,212,1,16.307692307692307
camel,org.apache.camel.test.infra.ibmmq.services,1,211,0,211,4,211.0
camel,org.apache.camel.itest.osgi.core.language,4,153,58,211,2,52.75
camel,org.apache.camel.component.xchange.metadata,12,155,56,211,2,17.583333333333332
camel,org.apache.camel.component.aws.swf.integration,6,195,16,211,2,35.166666666666664
camel,org.apache.camel.component.restlet.converter,13,126,85,211,2,16.23076923076923
camel,org.apache.camel.component.mail.mock,7,197,13,210,4,30.0
camel,org.apache.camel.component.azure.cosmosdb.client,7,194,16,210,2,30.0
camel,generated.java.org.apache.camel.component.vertx.common,1,0,210,210,3,210.0
camel,test.java.org.apache.camel.test.infra.etcd.services,1,0,209,209,4,209.0
camel,org.apache.camel.component.xmpp.integration,11,136,73,209,6,19.0
camel,org.apache.camel.component.google.pubsub.serializer,4,139,70,209,4,52.25
camel,org.apache.camel.component.kubernetes.consumer.integration.namespaces,1,209,0,209,3,209.0
camel,org.apache.camel.component.debezium.db2.configuration,6,200,9,209,2,34.833333333333336
camel,test.java.org.apache.camel.component.uface,2,0,208,208,4,104.0
camel,org.apache.camel.component.crypto.cms.util,6,194,14,208,4,34.666666666666664
camel,org.apache.camel.test.cdi.alternatives,2,204,4,208,5,104.0
camel,test.java.org.apache.camel.itest.spring2,1,0,208,208,3,208.0
camel,org.apache.camel.component.aws2.translate.integration,9,164,43,207,3,23.0
camel,org.apache.camel.spring.produce.generics,6,182,24,206,5,34.333333333333336
camel,test.java.org.apache.camel.component.validator.jing,2,0,206,206,3,103.0
camel,org.apache.camel.component.resilience4j.micrometer,2,205,0,205,2,102.5
camel,org.apache.camel.component.langchain4j.core,2,204,1,205,4,102.5
camel,org.apache.camel.dsl.jbang.core.components,3,102,102,204,3,68.0
camel,org.apache.camel.component.quickfix.converter,6,102,102,204,2,34.0
camel,generated.java.org.apache.camel.component.aries,1,0,204,204,3,204.0
camel,org.apache.camel.dsl.jbang.core.languages,3,102,102,204,3,68.0
camel,org.apache.camel.dsl.jbang.core.others,3,102,102,204,3,68.0
camel,test.java.org.apache.camel.component.dynamicrouter.integration,1,0,203,203,1,203.0
camel,test.java.org.apache.camel.language.simple,2,0,203,203,3,101.5
camel,generated.java.org.apache.camel.component.iota,1,0,203,203,3,203.0
camel,test.java.org.apache.camel.component.rabbitmq.integration.spring,1,0,203,203,2,203.0
camel,org.apache.camel.component.debezium.mongodb.configuration,5,197,6,203,2,40.6
camel,org.apache.camel.dataformat.bindy.model.simple.oneclassmandatory,6,180,23,203,2,33.833333333333336
camel,org.apache.camel.core.osgi.main.it,2,196,6,202,3,101.0
camel,org.apache.camel.itest.proxy,8,173,29,202,4,25.25
camel,test.java.org.apache.camel.catalog.maven,1,0,202,202,2,202.0
camel,test.java.org.apache.camel.itest.osgi.hazelcast,1,0,201,201,2,201.0
camel,test.java.org.apache.camel.component.sjms.typeconversion,1,0,201,201,1,201.0
camel,org.apache.camel.spring.xml.handler,14,124,77,201,5,14.357142857142858
camel,org.apache.camel.example.cdi.rest.servlet,8,132,68,200,3,25.0
camel,test.java.org.apache.camel.component.quickfixj.examples.transform,1,0,200,200,3,200.0
camel,test.java.org.apache.camel.test.cdi.alternatives,1,0,200,200,5,200.0
camel,org.apache.camel.itest.osgi.freemarker,7,163,37,200,2,28.571428571428573
camel,org.apache.camel.dsl.jbang.core.kamelets,3,100,100,200,3,66.66666666666667
camel,test.java.org.apache.camel.component.aws.sns.integration,2,0,200,200,3,100.0
camel,org.apache.camel.example.cafe.test,5,190,10,200,4,40.0
camel,test.java.org.apache.camel.component.jms.tuning,1,0,200,200,2,200.0
camel,test.java.org.apache.camel.itest.osgi.krati,1,0,199,199,3,199.0
camel,org.apache.camel.component.ibm.watson.discovery.integration,1,199,0,199,2,199.0
camel,org.apache.camel.component.aws.xray.component,8,183,16,199,4,24.875
camel,org.apache.camel.component.cxf.jms,11,140,59,199,2,18.09090909090909
camel,test.java.org.apache.camel.component.rabbitmq.testbeans,1,0,199,199,4,199.0
camel,org.apache.camel.itest.springboot.arquillian.container.util,2,197,2,199,2,99.5
camel,org.apache.camel.dataformat.bindy.fixed.number,9,170,29,199,1,22.11111111111111
camel,org.apache.camel.component.debezium.db2,5,179,19,198,5,39.6
camel,org.apache.camel.maven.bundle,6,99,99,198,3,33.0
camel,org.apache.camel.component.debezium.mongodb,5,179,19,198,5,39.6
camel,test.java.org.apache.camel.component.metrics,2,0,198,198,2,99.0
camel,org.apache.camel.component.debezium.mysql,5,179,19,198,5,39.6
camel,org.apache.camel.component.resilience.springboot,2,99,99,198,1,99.0
camel,org.apache.camel.catalog.lucene,19,159,39,198,6,10.421052631578947
camel,test.java.org.apache.camel.web.htmlunit,1,0,197,197,2,197.0
camel,org.apache.camel.component.nitrite.operation.collection,2,195,2,197,3,98.5
camel,test.java.org.apache.camel.component.aws.kinesis.integration,2,0,197,197,2,98.5
camel,org.apache.camel.itest.cxf,6,190,7,197,4,32.833333333333336
camel,generated.java.org.apache.camel.component.google.bigquery.sql,1,0,197,197,3,197.0
camel,org.apache.camel.dataformat.any23.writer,3,98,98,196,1,65.33333333333333
camel,org.apache.camel.component.sjms.manual,12,174,22,196,3,16.333333333333332
camel,test.java.org.apache.camel.component.aws2.kinesis.integration,2,0,196,196,2,98.0
camel,org.apache.camel.component.eventadmin.springboot,5,98,98,196,2,39.2
camel,org.apache.camel.example.servletlistener,4,98,98,196,2,49.0
camel,org.apache.camel.component.caffeine.resume.multi,2,98,98,196,1,98.0
camel,test.java.org.apache.camel.component.aws2.s3,2,0,196,196,2,98.0
camel,net.revelc.code.formatter.java,2,98,98,196,1,98.0
camel,org.apache.camel.component.paxlogging.springboot,5,98,98,196,2,39.2
camel,test.java.org.apache.camel.dataformat.swift.mt,1,0,195,195,2,195.0
camel,org.apache.camel.component.kafka.integration.common,4,123,72,195,3,48.75
camel,com.viwilo.camel.constants,1,195,0,195,5,195.0
camel,org.apache.camel.dataformat.bindy.model.fix.sorted.body,6,164,31,195,1,32.5
camel,org.apache.camel.component.aws2.ddb.integration,7,171,24,195,1,27.857142857142858
camel,test.java.org.apache.camel.itest.springboot.arquillian.container.util,1,0,195,195,2,195.0
camel,test.java.org.apache.camel.language.juel,1,0,194,194,4,194.0
camel,org.apache.camel.spring.config.scan.route,11,133,61,194,2,17.636363636363637
camel,test.java.org.apache.camel.component.aws2.eks,2,0,194,194,2,97.0
camel,org.apache.camel.example.server.model,3,97,97,194,3,64.66666666666667
camel,org.apache.camel.component.aws2.cw.localstack,5,146,48,194,2,38.8
camel,org.apache.camel.component.validator.relaxng,2,143,50,193,2,96.5
camel,org.apache.camel.test.blueprint.converter,7,177,16,193,5,27.571428571428573
camel,generated.java.org.apache.camel.component.kameletreify,1,0,193,193,3,193.0
camel,org.apache.camel.samples.jmstofile,6,141,52,193,1,32.166666666666664
camel,org.apache.camel.component.platform.http.vertx.model,1,166,27,193,3,193.0
camel,test.java.org.apache.camel.component.file.strategy,3,0,193,193,3,64.33333333333333
camel,org.apache.camel.processor.throttle.concurrent,6,168,25,193,5,32.166666666666664
camel,org.apache.camel.component.file.springboot.cluster,2,5,187,192,2,96.0
camel,test.java.org.apache.camel.component.infinispan.processor.aggregate,1,0,192,192,2,192.0
camel,org.apache.camel.language.xtokenizer.springboot,2,3,189,192,2,96.0
camel,org.apache.camel.component.gae.context,6,96,96,192,2,32.0
camel,org.apache.camel.component.xchange.account,12,138,54,192,1,16.0
camel,test.java.org.apache.camel.component.etcd.springboot.cloud,2,0,192,192,3,96.0
camel,org.apache.camel.component.huaweicloud.frs.mock,4,140,52,192,11,48.0
camel,test.java.org.apache.camel.component.dns.springboot.cloud,2,0,192,192,3,96.0
camel,org.apache.camel.component.jms.integration.consumers,4,187,4,191,3,47.75
camel,test.java.org.apache.camel.component.google.bigquery.unit,2,0,191,191,3,95.5
camel,org.apache.camel.component.jms.converter,1,191,0,191,3,191.0
camel,org.apache.camel.component.minio.integration.remoteTests,1,155,36,191,7,191.0
camel,test.java.org.apache.camel.itest.osgi.base64,1,0,190,190,1,190.0
camel,org.apache.camel.component.yammer.scribe,5,95,95,190,2,38.0
camel,org.apache.camel.component.kubernetes.build_configs.springboot,2,185,5,190,2,95.0
camel,generated.java.org.apache.camel.component.ipfs,1,0,189,189,3,189.0
camel,test.java.org.apache.camel.itest.osgi.xstream,1,0,189,189,3,189.0
camel,org.apache.camel.component.kubernetes.builds.springboot,2,184,5,189,2,94.5
camel,org.apache.camel.dsl.jbang.core.api,4,94,94,188,4,47.0
camel,test.java.org.apache.camel.component.azure.eventhubs.operations,1,0,188,188,1,188.0
camel,org.apache.camel.example.springboot.infinispan,4,94,94,188,2,47.0
camel,org.apache.camel.component.file.springboot.ha,2,185,3,188,2,94.0
camel,org.apache.camel.component.reactive.streams.tck,14,143,45,188,4,13.428571428571429
camel,org.apache.camel.non_wrapper,17,160,28,188,3,11.058823529411764
camel,test.java.org.apache.camel.swagger.component,1,0,187,187,3,187.0
camel,org.apache.camel.reifier.tokenizer,4,135,52,187,2,46.75
camel,org.apache.camel.spring.aop,12,162,24,186,3,15.5
camel,org.apache.camel.component.wordpress.api.auth,7,170,16,186,3,26.571428571428573
camel,test.java.org.apache.camel.dataformat.beanio.csv,1,0,185,185,2,185.0
camel,org.apache.camel.component.spring.ws.processor,7,163,22,185,3,26.428571428571427
camel,org.apache.camel.component.leveldb.serializer.jackson,3,182,3,185,4,61.666666666666664
camel,org.apache.camel.component.whatsapp.util,1,185,0,185,2,185.0
camel,test.java.org.apache.camel.loanbroker.queue.version,2,0,185,185,3,92.5
camel,org.apache.camel.component.grpc.auth.jwt,10,108,77,185,4,18.5
camel,test.java.org.apache.camel.dsl.modeline,1,0,185,185,1,185.0
camel,org.apache.camel.component.rabbitmq.pool,7,92,92,184,1,26.285714285714285
camel,org.apache.camel.dataformat,2,5,179,184,4,92.0
camel,test.java.org.apache.camel.component.mail.mock,1,0,184,184,4,184.0
camel,org.apache.camel.dsl.jbang.core.types,3,92,92,184,4,61.333333333333336
camel,org.apache.camel.component.cassandra.consumer.support,5,162,22,184,4,36.8
camel,test.java.org.apache.camel.itest.cxf,1,0,183,183,4,183.0
camel,org.apache.camel.catalog.console,8,160,23,183,1,22.875
camel,test.java.org.apache.camel.component.context,1,0,183,183,3,183.0
camel,test.java.org.apache.camel.component.hazelcast.springboot.customizer,2,0,182,182,1,91.0
camel,org.apache.camel.cdi.component.properties,3,134,48,182,3,60.666666666666664
camel,org.apache.camel.lanaguage.sql,7,163,18,181,2,25.857142857142858
camel,test.java.org.apache.camel.component.aws.translate,1,0,181,181,3,181.0
camel,test.java.org.apache.camel.itest.osgi.mybatis,1,0,181,181,2,181.0
camel,test.java.org.apache.camel.component.infinispan.remote.cluster,1,0,181,181,3,181.0
camel,test.java.org.apache.camel.component.hipchat.integration,1,0,181,181,2,181.0
camel,test.java.org.apache.camel.component.crypto.cms.util,1,0,180,180,4,180.0
camel,test.java.org.apache.camel.example.cafe.test,1,0,180,180,4,180.0
camel,org.apache.camel.itest.hawtdb,6,171,9,180,3,30.0
camel,org.apache.camel.spring.primary,1,180,0,180,4,180.0
camel,generated.java.org.apache.camel.component.validator.jing,1,0,180,180,3,180.0
camel,test.java.org.apache.camel.model.rest.springboot,1,0,180,180,1,180.0
camel,org.apache.camel.tests.performance,7,156,23,179,2,25.571428571428573
camel,org.apache.camel.component.sjms.converter,1,179,0,179,3,179.0
camel,test.java.org.apache.camel.converter.aries,1,0,179,179,3,179.0
camel,org.apache.camel.spring.processor.scattergather,16,157,22,179,3,11.1875
camel,test.java.org.apache.camel.dataformat.csv,2,0,179,179,2,89.5
camel,test.java.org.apache.camel.component.aws.swf.integration,2,0,179,179,2,89.5
camel,test.java.org.apache.camel.tests.typeconverterscan,1,0,179,179,3,179.0
camel,org.apache.camel.hamcrest,5,110,68,178,2,35.6
camel,test.java.org.apache.camel.component.microprofile.metrics.event.notifier.route,2,0,178,178,2,89.0
camel,org.apache.camel.component.netty4.http.cloud,5,166,12,178,6,35.6
camel,org.apache.camel.component.jacksonxml.converter,13,166,12,178,2,13.692307692307692
camel,test.java.org.apache.camel.spring.boot.fatjarroutertests,1,0,178,178,3,178.0
camel,org.apache.camel.component.reactive.streams.springboot.test.support,5,172,6,178,1,35.6
camel,org.apache.camel.component.djl.training,8,132,46,178,1,22.25
camel,test.java.org.apache.camel.itest.karaf.activator,1,0,178,178,2,178.0
camel,org.apache.camel.cdi.converter,6,88,89,177,2,29.5
camel,org.apache.camel.osgi.test,7,155,22,177,4,25.285714285714285
camel,org.apache.camel.itest.osgi.core.bean,4,146,31,177,3,44.25
camel,org.apache.camel.component.file.watch.utils,4,105,72,177,2,44.25
camel,org.apache.camel.test.infra.aws.clients,2,172,4,176,1,88.0
camel,org.apache.camel.component.aws.xray.bean,6,166,10,176,3,29.333333333333332
camel,org.apache.camel.itest.osgi.syslog,7,141,35,176,1,25.142857142857142
camel,org.apache.camel.constants,2,173,3,176,9,88.0
camel,org.apache.camel.component.nitrite.operation.repository,4,174,2,176,3,44.0
camel,test.java.org.apache.camel.itest.idempotent,2,0,176,176,3,88.0
camel,org.apache.camel.example.transformer,6,158,18,176,1,29.333333333333332
camel,org.apache.camel.maven.htmlxlsx,1,175,0,175,1,175.0
camel,org.apache.camel.component.firebase.provider,5,130,45,175,2,35.0
camel,test.java.org.apache.camel.component.google.pubsub.unit,2,0,175,175,3,87.5
camel,org.apache.camel.dsl.xml.jaxb.management,2,122,53,175,8,87.5
camel,org.apache.camel.example.artemis.amqp,10,142,33,175,3,17.5
camel,org.apache.camel.component.xmlrpc.converter,3,115,59,174,2,58.0
camel,org.apache.camel.component.rabbitmq.integration.spring,7,118,56,174,2,24.857142857142858
camel,org.apache.camel.jmxconnect.provider.camel,4,87,87,174,2,43.5
camel,org.apache.camel.dataformat.bindy.model.simple.oneclassemptystream,3,171,3,174,1,58.0
camel,org.apache.camel.itest.osgi.saxon,2,173,0,173,2,86.5
camel,test.java.org.apache.camel.itest.osgi.saxon,1,0,173,173,2,173.0
camel,test.java.org.apache.camel.component.pqc,1,0,173,173,2,173.0
camel,org.apache.camel.component.aws2.ecs.integration,9,151,22,173,3,19.22222222222222
camel,test.java.org.apache.camel.component.google.bigquery.integration.sql,1,0,173,173,2,173.0
camel,org.apache.camel.component.netty.codec,4,92,80,172,15,43.0
camel,org.apache.camel.spring.boot.dummy,4,161,11,172,3,43.0
camel,org.apache.camel.example.springboot.livereload,3,86,86,172,2,57.333333333333336
camel,test.java.org.apache.camel.main.support,1,0,171,171,3,171.0
camel,org.apache.camel.component.gson.converter,2,115,56,171,2,85.5
camel,org.apache.camel.dataformat.bindy.model.simple.oneclassgenerateheader,4,164,7,171,1,42.75
camel,org.apache.camel.component.activemq.support,3,109,62,171,3,57.0
camel,test.java.org.apache.camel.oaipmh.utils,1,0,171,171,1,171.0
camel,org.apache.camel.component.aws2.bedrock.agent.integration,8,156,14,170,2,21.25
camel,test.java.org.apache.camel.component.google.pubsub,1,0,170,170,1,170.0
camel,org.apache.camel.component.huaweicloud.iam.models,4,112,58,170,2,42.5
camel,test.java.org.apache.camel.component.atomix.client,1,0,169,169,3,169.0
camel,test.java.org.apache.camel.itest.osgi.hdfs,1,0,169,169,2,169.0
camel,test.java.org.apache.camel.component.jms.tx,1,0,169,169,2,169.0
camel,test.java.org.apache.camel.itest.ftp,1,0,168,168,1,168.0
camel,org.apache.camel.component.fory,4,102,66,168,4,42.0
camel,test.java.org.apache.camel.catalog.connector,1,0,168,168,1,168.0
camel,test.java.org.apache.camel.itest.osgi.core.file,1,0,168,168,3,168.0
camel,org.apache.camel.component.cm.client,6,154,14,168,4,28.0
camel,test.java.org.apache.camel.test.infra.aws.clients,1,0,168,168,1,168.0
camel,test.java.org.apache.camel.component.zookeeper.springboot.cloud,1,0,168,168,1,168.0
camel,test.java.org.apache.camel.component.bean.pojomessage,1,0,167,167,3,167.0
camel,test.java.org.apache.camel.component.twitter.search,1,0,167,167,2,167.0
camel,org.apache.camel.test.blueprint.xpath,6,154,13,167,3,27.833333333333332
camel,org.apache.camel.dataformat.bindy.model.simple.oneclasssinglequote,3,162,5,167,1,55.666666666666664
camel,org.apache.camel.component.yammer.utils,5,83,83,166,1,33.2
camel,org.apache.camel.example.fhir,4,83,83,166,1,41.5
camel,test.java.org.apache.camel.component.reactive.streams.springboot.test.support,1,0,166,166,1,166.0
camel,org.apache.camel.component.aws2.iam.client,9,157,9,166,3,18.444444444444443
camel,org.apache.camel.component.netty.util,5,80,86,166,1,33.2
camel,test.java.org.apache.camel.ruby,1,0,166,166,3,166.0
camel,org.apache.camel.spring.boot.fatjarrouter,4,157,8,165,3,41.25
camel,org.apache.camel.cdi.expression,4,76,88,164,1,41.0
camel,org.apache.camel.itest.osgi.management,3,160,4,164,2,54.666666666666664
camel,test.java.org.apache.camel.example.axis,1,0,163,163,2,163.0
camel,test.java.org.apache.camel.example.cdi.two,1,0,163,163,3,163.0
camel,test.java.org.apache.camel.component.spring.batch,1,0,163,163,1,163.0
camel,org.apache.camel.spring.health,7,120,43,163,2,23.285714285714285
camel,test.java.org.apache.camel.component.ldap,1,0,163,163,1,163.0
camel,org.apache.camel.component.flink.annotations,10,144,19,163,2,16.3
camel,test.java.org.apache.camel.itest.osgi.servlet,1,0,163,163,3,163.0
camel,org.apache.camel.dataformat.bindy.model.simple.oneclassandremovewhitespace,3,160,3,163,1,54.333333333333336
camel,test.java.org.apache.camel.component.http.rest,1,0,163,163,1,163.0
camel,org.apache.camel.component.azure.eventhubs.integration,5,150,12,162,4,32.4
camel,test.java.org.apache.camel.itest.hawtdb,1,0,162,162,3,162.0
camel,org.apache.camel.itest.osgi.hawtdb,6,131,31,162,1,27.0
camel,org.apache.camel.component.elasticsearch5.aggregation,4,107,55,162,2,40.5
camel,test.java.org.apache.camel.test.blueprint.converter,1,0,161,161,4,161.0
camel,org.apache.camel.clock,4,148,13,161,3,40.25
camel,test.java.org.apache.camel.component.infinispan.policy,1,0,161,161,3,161.0
camel,org.apache.camel.component.huaweicloud.image.models,1,161,0,161,1,161.0
camel,test.java.org.apache.camel.swagger.producer,1,0,160,160,3,160.0
camel,org.apache.camel.example.restlet.jdbc,5,80,80,160,1,32.0
camel,test.java.org.apache.camel.spring.processor.async,1,0,160,160,5,160.0
camel,org.apache.camel.component.aws2.kinesis.client,7,143,15,158,3,22.571428571428573
camel,test.java.org.apache.camel.component.platform.http.vertx,1,0,158,158,1,158.0
camel,org.apache.camel.component.kafka.consumer.support.subcription,3,155,2,157,3,52.333333333333336
camel,test.java.org.apache.camel.component.netty4.http,3,0,157,157,3,52.333333333333336
camel,org.apache.camel.itest.nettyhttp,11,113,44,157,1,14.272727272727273
camel,org.apache.camel.opentracing.agent,10,125,32,157,1,15.7
camel,test.java.org.apache.camel.component.mongodb.meta.integration,1,0,157,157,1,157.0
camel,generated.java.org.apache.camel.component.etcd3.cloud,1,0,157,157,1,157.0
camel,org.apache.camel.component.djl.model.timeseries,3,150,7,157,2,52.333333333333336
camel,org.apache.camel.itest.osgi.dozer,9,116,40,156,1,17.333333333333332
camel,test.java.org.apache.camel.web.util,2,0,156,156,3,78.0
camel,org.apache.camel.observation.otel,1,156,0,156,3,156.0
camel,test.java.org.apache.camel.component.undertow.ws,1,0,155,155,1,155.0
camel,test.java.org.apache.camel.cdi.pojo,1,0,155,155,5,155.0
camel,test.java.org.apache.camel.component.jbpm.server,1,0,155,155,1,155.0
camel,org.apache.camel.component.spring.ws.filter,5,100,55,155,1,31.0
camel,org.apache.camel.jandex,1,154,0,154,1,154.0
camel,test.java.org.apache.camel.component.soroushbot.utils,1,0,154,154,1,154.0
camel,org.apache.camel.main.fatjar,3,151,3,154,2,51.333333333333336
camel,org.apache.camel.component.rabbitmq.test.infra.services,5,147,7,154,2,30.8
camel,org.apache.camel.component.braintree.integration,1,103,51,154,17,154.0
camel,org.apache.camel.example.cdi.cassandraql,6,77,77,154,1,25.666666666666668
camel,org.apache.camel.component.hystrix.springboot.test,3,149,4,153,2,51.0
camel,org.apache.camel.example.springboot.metrics,3,136,17,153,2,51.0
camel,org.apache.camel.maven.component,7,132,21,153,1,21.857142857142858
camel,org.apache.camel.component.kamelet.utils.langchain4j.chat,1,153,0,153,2,153.0
camel,org.apache.camel.component.cxf.noparam,10,139,14,153,5,15.3
camel,org.apache.camel.example.kafka.offsetRepository,2,76,76,152,2,76.0
camel,org.apache.camel.guice.produce,7,134,18,152,3,21.714285714285715
camel,org.apache.camel.component.platform.http.vertx.auth,3,142,10,152,2,50.666666666666664
camel,test.java.org.apache.camel.dsl.jbang,1,0,152,152,1,152.0
camel,test.java.org.apache.camel.component.etcd3.policy,1,0,152,152,2,152.0
camel,test.java.org.apache.camel.spring.patterns,3,0,152,152,3,50.666666666666664
camel,org.apache.camel.component.aws.common,6,98,54,152,2,25.333333333333332
camel,org.apache.camel.component.consul.support,2,141,10,151,4,75.5
camel,org.apache.camel.dataformat.bindy.number.rounding,9,126,25,151,1,16.77777777777778
camel,org.apache.camel.component.yql.exception,4,75,75,150,2,37.5
camel,org.apache.camel.component.consul.springboot.cluster,5,10,140,150,2,30.0
camel,org.apache.camel.component.processor,5,138,12,150,2,30.0
camel,test.java.org.apache.camel.example.fhir.osgi,1,0,150,150,2,150.0
camel,test.java.org.apache.camel.itest.osgi.core.xslt,1,0,150,150,2,150.0
camel,org.apache.camel.tracing.propagation,7,73,77,150,6,21.428571428571427
camel,org.apache.camel.dataformat.bindy.model.fix.sorted.header,7,128,22,150,1,21.428571428571427
camel,test.java.org.apache.camel.spring.boot.dummy,1,0,150,150,3,150.0
camel,test.java.org.apache.camel.component.salesforce.api.dto.composite,1,0,150,150,1,150.0
camel,org.apache.camel.component.splunkhec.integration,8,121,29,150,3,18.75
camel,org.apache.camel.resume.cache,9,107,43,150,3,16.666666666666668
camel,test.java.org.apache.camel.component.atmos,2,0,149,149,2,74.5
camel,test.java.org.apache.camel.component.mongodb.gridfs,2,0,149,149,2,74.5
camel,org.apache.camel.itest.osgi.servlet.support,9,120,29,149,1,16.555555555555557
camel,org.apache.camel.main.console,9,126,23,149,1,16.555555555555557
camel,org.apache.camel.component.kubernetes.springboot.test.cloud,3,146,2,148,1,49.333333333333336
camel,generated.java.org.apache.camel.component.validator.msv,1,0,148,148,3,148.0
camel,org.apache.camel.component.couchbase.consumer.support,3,74,74,148,1,49.333333333333336
camel,org.apache.camel.component.jms.integration.spring,3,81,67,148,13,49.333333333333336
camel,org.apache.camel.component.paho.mqtt5.integration,5,119,29,148,6,29.6
camel,test.java.org.apache.camel.dataformat.xmlrpc,1,0,147,147,2,147.0
camel,test.java.org.apache.camel.component.consul.cloud,1,0,147,147,2,147.0
camel,test.java.org.apache.camel.component.aws2.ddb.integration,1,0,147,147,1,147.0
camel,org.apache.camel.component.aws.firehose.integration,8,132,15,147,2,18.375
camel,org.apache.camel.catalog.suggest,1,147,0,147,2,147.0
camel,org.apache.camel.component.smb.converter,2,106,41,147,2,73.5
camel,test.java.org.apache.camel.builder.sql,1,0,147,147,2,147.0
camel,test.java.org.apache.camel.itest.osgi.mail,1,0,146,146,1,146.0
camel,org.apache.camel.xbean,3,145,1,146,2,48.666666666666664
camel,org.apache.camel.component.spring.ws.utils,4,136,10,146,2,36.5
camel,org.apache.camel.component.jms.integration.spring.tx.error,1,45,101,146,8,146.0
camel,test.java.org.apache.camel.component.infinispan.embedded,2,0,146,146,2,73.0
camel,test.java.org.apache.camel.lanaguage.sql,1,0,145,145,2,145.0
camel,org.apache.camel.itest.osgi.rss,6,115,30,145,1,24.166666666666668
camel,test.java.org.apache.camel.component.hystrix.springboot.test,1,0,145,145,2,145.0
camel,test.java.org.apache.camel.spring.javaconfig,1,0,145,145,2,145.0
camel,org.apache.camel.itest.osgi.xmljson,6,132,13,145,2,24.166666666666668
camel,org.apache.camel.test.infra.azure.storage.datalake.services,4,130,15,145,3,36.25
camel,test.java.org.apache.camel.component.etcd3.cloud.integration,1,0,144,144,1,144.0
camel,test.java.org.apache.camel.itest.cdi,1,0,144,144,2,144.0
camel,test.java.org.apache.camel.component.microprofile.metrics.event.notifier.context,2,0,144,144,2,72.0
camel,test.java.org.apache.camel.itest.proxy,2,0,144,144,4,72.0
camel,org.apache.camel.component.jgroups.springboot.cluster.springboot,4,8,136,144,2,36.0
camel,org.apache.camel.example.cdi.aws.s3,8,72,72,144,1,18.0
camel,org.apache.camel.itest.osgi.jasypt,8,108,36,144,1,18.0
camel,org.apache.camel.openapi.jmx,7,112,32,144,1,20.571428571428573
camel,test.java.org.apache.camel.component.kura,1,0,144,144,1,144.0
camel,test.java.org.apache.camel.component.kubernetes.springboot.test.cloud,1,0,144,144,1,144.0
camel,org.apache.camel.maven.integration,11,132,12,144,1,13.090909090909092
camel,org.apache.camel.component.etcd3.cloud.integration,2,144,0,144,1,72.0
camel,library,2,144,0,144,1,72.0
camel,org.apache.camel.component.quickfixj.examples.routing,9,125,18,143,1,15.88888888888889
camel,test.java.org.apache.camel.component.kubernetes.springboot.test.cluster,2,0,143,143,2,71.5
camel,org.apache.camel.test.infra.core.api,5,138,5,143,3,28.6
camel,test.java.org.apache.camel.cdi.store,1,0,143,143,2,143.0
camel,org.apache.camel.itest.osgi.jms,8,108,35,143,1,17.875
camel,org.apache.camel.component.djl.model.tabular,3,133,9,142,3,47.333333333333336
camel,org.apache.camel.language.sql,6,71,71,142,1,23.666666666666668
camel,test.java.org.apache.camel.test.blueprint.xpath,1,0,141,141,3,141.0
camel,com.example,7,130,11,141,4,20.142857142857142
camel,generated.java.org.apache.camel.component.twilio.internal,1,0,141,141,2,141.0
camel,test.java.org.apache.camel.component.iota,1,0,141,141,1,141.0
camel,test.java.org.apache.camel.component.hbase.processor.idempotent,1,0,141,141,1,141.0
camel,org.apache.camel.component.zookeeper.ha.springboot,3,135,5,140,2,46.666666666666664
camel,org.apache.camel.component.consul.springboot.ha,3,135,5,140,2,46.666666666666664
camel,org.apache.camel.itest.osgi.spring.xslt,6,72,68,140,1,23.333333333333332
camel,org.apache.camel.parser.graph,2,70,70,140,1,70.0
camel,test.java.org.apache.camel.catalog.springboot,1,0,140,140,1,140.0
camel,test.java.org.apache.camel.component.file.remote.sftp,2,0,140,140,3,70.0
camel,org.apache.camel.test.main.junit5.annotation.custom,2,140,0,140,2,70.0
camel,test.java.org.apache.camel.example.transformer,1,0,140,140,1,140.0
camel,test.java.org.apache.camel.component.rabbitmq.test.infra.services,1,0,140,140,2,140.0
camel,test.java.org.apache.camel.dsl.js,1,0,140,140,1,140.0
camel,org.apache.camel.test.blueprint.converter2,4,128,12,140,3,35.0
camel,org.apache.camel.component.google.storage.transform,6,131,8,139,2,23.166666666666668
camel,test.java.org.apache.camel.component.ssh,2,0,139,139,3,69.5
camel,org.apache.camel.component.pdf.converter,4,136,3,139,2,34.75
camel,org.apache.camel.component.huaweicloud.frs.constants,1,139,0,139,4,139.0
camel,test.java.org.apache.camel.loanbroker,1,0,139,139,2,139.0
camel,org.apache.camel.itest.osgi.ahc,7,108,31,139,1,19.857142857142858
camel,org.apache.camel.component.docker.util,6,132,7,139,1,23.166666666666668
camel,org.apache.camel.component.as2.api.exception,1,139,0,139,4,139.0
camel,org.apache.camel.example.spring.boot.metrics,6,10,129,139,1,23.166666666666668
camel,org.apache.camel.component.apns.spring,10,113,26,139,1,13.9
camel,test.java.org.apache.camel.spring.boot.actuate.health,2,0,139,139,3,69.5
camel,org.apache.camel.component.azure.storage.blob.transform,7,131,8,139,2,19.857142857142858
camel,test.java.org.apache.camel.component.apns.factory,1,0,139,139,2,139.0
camel,org.apache.camel.spring.contextscan,7,124,14,138,2,19.714285714285715
camel,test.java.org.apache.camel.dataformat.jibx.model,1,0,138,138,2,138.0
camel,org.apache.camel.component.openstack,15,99,39,138,1,9.2
camel,test.java.org.apache.camel.component.zookeeper,2,0,138,138,2,69.0
camel,test.java.org.apache.camel.component.google.functions.integration,1,0,138,138,1,138.0
camel,org.apache.camel.component.kamelet.utils.langchain4j.embeddings,2,137,0,137,2,68.5
camel,org.apache.camel.component.jetty.manual,12,98,39,137,3,11.416666666666666
camel,test.java.org.apache.camel.component.etcd.support,1,0,137,137,2,137.0
camel,test.java.org.apache.camel.component.zookeeper.cluster,1,0,137,137,2,137.0
camel,test.java.org.apache.camel.component.sjms.it,1,0,137,137,1,137.0
camel,org.apache.camel.component.bonita.producer,7,111,26,137,2,19.571428571428573
camel,org.apache.camel.component.aws2.sqs.transform,6,129,7,136,2,22.666666666666668
camel,org.apache.camel.itest.osgi.restlet,6,104,32,136,1,22.666666666666668
camel,org.apache.camel.language.ognl.patterns,10,94,41,135,1,13.5
camel,org.apache.camel.component.aws2.firehose.integration,9,107,28,135,2,15.0
camel,test.java.org.apache.camel.spring.boot.zlast,1,0,135,135,2,135.0
camel,org.apache.camel.spring.impl.converter,4,133,2,135,3,33.75
camel,test.java.org.apache.camel.component.xmpp,1,0,135,135,1,135.0
camel,test.java.org.apache.camel.itest.osgi.script,1,0,135,135,2,135.0
camel,org.apache.camel.component.thrift.local,7,121,14,135,1,19.285714285714285
camel,org.apache.camel.component.kamelet.utils.transform.kafka,2,133,2,135,3,67.5
camel,test.java.org.apache.camel.component.spring.ws.jaxb,1,0,134,134,3,134.0
camel,org.apache.camel.component.huaweicloud.image.constants,1,134,0,134,4,134.0
camel,test.java.org.apache.camel.component.mongodb.verifier.integration,1,0,134,134,1,134.0
camel,test.java.org.apache.camel.component.netty.http.springboot,1,0,134,134,2,134.0
camel,test.java.org.apache.camel.example.cdi.one,1,0,134,134,2,134.0
camel,org.apache.camel.itest.osgi.quartz,9,98,36,134,1,14.88888888888889
camel,test.java.org.apache.camel.component.soroushbot.service,1,0,134,134,1,134.0
camel,test.java.org.apache.camel.component.jacksonxml,2,0,133,133,2,66.5
camel,test.java.org.apache.camel.component.kamelet.utils.transform,1,0,133,133,1,133.0
camel,test.java.org.apache.camel.itest.osgi.shiro,1,0,133,133,1,133.0
camel,test.java.org.apache.camel.tests.performance,1,0,133,133,2,133.0
camel,test.java.org.apache.camel.component.yql.configuration,1,0,133,133,1,133.0
camel,org.apache.camel.itest.osgi.exec,5,97,36,133,1,26.6
camel,org.apache.camel.component.infinispan.processor.query,2,66,66,132,2,66.0
camel,org.apache.camel.language.constant,14,102,30,132,4,9.428571428571429
camel,test.java.org.apache.camel.component.undertow.rest,1,0,132,132,1,132.0
camel,org.apache.camel.component.aws.translate.integration,7,112,20,132,1,18.857142857142858
camel,test.java.org.apache.camel.component.krati.processor.idempotent,1,0,132,132,1,132.0
camel,org.apache.camel.component.milvus.transform,6,120,11,131,2,21.833333333333332
camel,generated.java.org.apache.camel.component.eventadmin,1,0,131,131,2,131.0
camel,org.apache.camel.component.kubernetes.springboot.test.ha,1,130,0,130,2,130.0
camel,org.apache.camel.converter.myconverter,11,88,42,130,13,11.818181818181818
camel,org.apache.camel.dsl.jbang.core.commands.exceptionhandler,3,127,3,130,2,43.333333333333336
camel,org.apache.camel.component.jms.config,13,90,39,129,1,9.923076923076923
camel,org.apache.camel.test.infra.aws.common.services,9,96,33,129,2,14.333333333333334
camel,org.apache.camel.support.startup.jfr,1,129,0,129,2,129.0
camel,test.java.org.apache.camel.component.kubernetes.springboot.cloud,1,0,129,129,2,129.0
camel,org.apache.camel.component.jgroups.springboot.ha.springboot,3,128,0,128,2,42.666666666666664
camel,generated.java.org.apache.camel.component.vm,1,0,128,128,3,128.0
camel,org.apache.camel.component.spring.security.keycloak,2,124,4,128,3,64.0
camel,test.java.org.apache.camel.component.langchain4j.chat,1,0,128,128,1,128.0
camel,org.apache.camel.component.util,5,124,4,128,2,25.6
camel,org.apache.camel.component.twitter.consumer.directmessage,7,91,37,128,1,18.285714285714285
camel,org.apache.camel.example.karaf.tika.detect,2,64,64,128,1,64.0
camel,org.apache.camel.component.sjms.bugfixes,9,109,19,128,2,14.222222222222221
camel,org.apache.camel.component.qdrant.transform,6,120,8,128,3,21.333333333333332
camel,org.apache.camel.component.infinispan.remote.protostream,2,123,5,128,3,64.0
camel,org.apache.camel.component.huaweicloud.iam.constants,3,125,3,128,4,42.666666666666664
camel,test.java.org.apache.camel.component.vertx.kafka.serde,1,0,127,127,2,127.0
camel,org.apache.camel.main.reload,4,106,21,127,1,31.75
camel,org.apache.camel.processor.lucene.support,6,121,6,127,2,21.166666666666668
camel,test.java.org.apache.camel.component.stream,1,0,127,127,2,127.0
camel,test.java.org.apache.camel.component.irc,1,0,127,127,1,127.0
camel,org.apache.camel.component.aws.ses.integration,7,120,7,127,2,18.142857142857142
camel,test.java.org.apache.camel.component.slack,1,0,126,126,1,126.0
camel,test.java.org.apache.camel.component.mina2,1,0,126,126,1,126.0
camel,org.apache.camel.dataformat.bindy.number.grouping,8,63,63,126,1,15.75
camel,org.apache.camel.test.infra.activemq.common,8,121,5,126,2,15.75
camel,generated.java.org.apache.camel.component.xmlsecurity,1,0,126,126,2,126.0
camel,org.apache.camel.component.langchain4j.tokenizer.config,2,114,12,126,2,63.0
camel,org.apache.camel.example.transformer.cdi,6,63,63,126,1,21.0
camel,org.apache.camel.test.blueprint.cloud,5,119,7,126,2,25.2
camel,test.java.org.apache.camel.itest.osgi.freemarker,1,0,126,126,2,126.0
camel,org.apache.camel.dataformat.bindy.model.simple.spanLastRecord,4,124,2,126,3,31.5
camel,org.apache.camel.dataformat.bindy.model.simple.linkonetomany,3,121,4,125,2,41.666666666666664
camel,org.apache.camel.component.kubernetes.springboot.test.cluster,5,69,56,125,2,25.0
camel,test.java.org.apache.camel.component.aws.cw.integration,2,0,125,125,2,62.5
camel,org.apache.camel.component.consul.springboot.cloud.support,1,125,0,125,3,125.0
camel,test.java.org.apache.camel.component.consul.support,1,0,125,125,3,125.0
camel,org.apache.camel.processor.juel,8,109,16,125,1,15.625
camel,test.java.org.apache.camel.component.consul.springboot.cloud.support,1,0,125,125,3,125.0
camel,org.apache.camel.component.cm.validation.constraints,4,117,8,125,4,31.25
camel,test.java.org.apache.camel.component.jt400,2,0,124,124,2,62.0
camel,test.java.org.apache.camel.component.minio,2,0,124,124,2,62.0
camel,test.java.org.apache.camel.impl.cloud,2,0,124,124,2,62.0
camel,org.apache.camel.component.bonita.integration,7,107,17,124,3,17.714285714285715
camel,org.apache.camel.itest.osgi.http4,5,100,24,124,1,24.8
camel,org.apache.camel.itest.osgi.core.ref,3,94,30,124,1,41.333333333333336
camel,test.integration.org.apache.camel.component.websocket,1,0,124,124,2,124.0
camel,org.apache.camel.component.google.storage.client,2,62,62,124,3,62.0
camel,org.apache.camel.component.foo,1,124,0,124,3,124.0
camel,test.java.org.apache.camel.test.testcontainers.spring.junit5,2,0,124,124,2,62.0
camel,test.java.org.apache.camel.test.testcontainers.spring,2,0,124,124,2,62.0
camel,test.java.org.apache.camel.component.etcd3,1,0,123,123,2,123.0
camel,org.apache.camel.itest.osgi.core.xslt,7,108,15,123,2,17.571428571428573
camel,org.apache.camel.dsl.jbang.launcher,1,123,0,123,2,123.0
camel,org.apache.camel.component.infinispan.util,6,100,23,123,3,20.5
camel,org.apache.camel.dsl.xml.jaxb.swagger,3,118,5,123,3,41.0
camel,org.apache.camel.component.platform.http.main.jolokia,3,121,2,123,1,41.0
camel,test.java.org.apache.camel.test.oauth,1,0,123,123,1,123.0
camel,org.apache.camel.main.stub,3,121,1,122,3,40.666666666666664
camel,org.apache.camel.dataformat.bindy.model.simple.oneclassmath,7,92,30,122,1,17.428571428571427
camel,test.java.org.apache.camel.language.script,2,0,122,122,3,61.0
camel,generated.java.org.apache.camel.component.activemq.converter,1,0,122,122,2,122.0
camel,org.apache.camel.component.aws2.s3.client,11,102,20,122,4,11.090909090909092
camel,org.apache.camel.itest.osgi.stream,7,91,31,122,1,17.428571428571427
camel,test.java.org.apache.camel.spring.boot.security,1,0,122,122,2,122.0
camel,org.apache.camel.core.osgi.main.internal,2,118,3,121,2,60.5
camel,org.apache.camel.component.kamelet.utils.format.schema,1,121,0,121,1,121.0
camel,test.java.org.apache.camel.spring.managment,1,0,121,121,1,121.0
camel,test.java.org.apache.camel.component.microprofile.config,1,0,121,121,1,121.0
camel,org.apache.camel.component.properties.route2,6,99,22,121,2,20.166666666666668
camel,org.apache.camel.jsonpath.jackson,9,105,16,121,1,13.444444444444445
camel,org.apache.camel.itest.osgi.netty,5,91,29,120,1,24.0
camel,org.apache.camel.component.weaviate.transform,2,110,10,120,1,60.0
camel,org.apache.camel.component.google.drive.integration,1,84,36,120,12,120.0
camel,org.apache.camel.component.spring.ws.util,4,105,15,120,1,30.0
camel,org.apache.camel.spring.cloud.consul.support,1,120,0,120,3,120.0
camel,org.apache.camel.itest.osgi.mina,5,91,29,120,1,24.0
camel,test.java.org.apache.camel.component.validator,1,0,119,119,1,119.0
camel,test.java.org.apache.camel.itest.osgi.xmljson,1,0,119,119,2,119.0
camel,org.apache.camel.spring.main,4,113,6,119,3,29.75
camel,org.apache.camel.core.osgi.test,17,100,19,119,8,7.0
camel,org.apache.camel.component.elasticsearch.integration,3,61,58,119,8,39.666666666666664
camel,org.apache.camel.rest,5,98,20,118,1,23.6
camel,org.apache.camel.component.as2.converter,11,108,10,118,2,10.727272727272727
camel,generated.java.org.apache.camel.component.paxlogging,1,0,118,118,2,118.0
camel,org.apache.camel.component.pinecone.transform,5,110,8,118,3,23.6
camel,test.java.org.apache.camel.component.aws.firehose.integration,2,0,117,117,2,58.5
camel,org.apache.camel.component.netty.http.cloud,8,84,33,117,4,14.625
camel,org.apache.camel.component.iec60870.testing,5,97,20,117,1,23.4
camel,org.apache.camel.itest.osgi.core.browse,3,86,31,117,1,39.0
camel,org.apache.camel.itest.osgi.core.properties,4,84,33,117,1,29.25
camel,org.apache.camel.component.digitalocean.constants,5,66,51,117,5,23.4
camel,org.apache.camel.itest.osgi.core.dataset,3,88,29,117,1,39.0
camel,test.java.org.apache.camel.guice.produce,1,0,116,116,3,116.0
camel,test.java.org.apache.camel.test.infra.activemq.common,1,0,116,116,2,116.0
camel,test.java.org.apache.camel.test.blueprint.converter2,1,0,116,116,3,116.0
camel,test.java.org.apache.camel.cdi.qualifier,1,0,116,116,3,116.0
camel,org.apache.camel.test.infra.common.http,4,98,18,116,1,29.0
camel,test.java.org.apache.camel.impl.health,1,0,116,116,1,116.0
camel,test.java.org.apache.camel.itest.osgi.protobuf,1,0,116,116,1,116.0
camel,org.apache.camel.itest.osgi.util.jsse,6,102,14,116,1,19.333333333333332
camel,test.java.org.apache.camel.itest.osgi.core.bean,1,0,115,115,3,115.0
camel,org.apache.camel.component.nitrite.operation,3,111,4,115,4,38.333333333333336
camel,org.apache.camel.component.google.pubsublite.consumer,1,115,0,115,2,115.0
camel,org.apache.camel.core.osgi.other,4,110,5,115,4,28.75
camel,org.apache.camel.example.jms,3,108,7,115,1,38.333333333333336
camel,tooling.camel-eclipse.camel.routing.editor.src-gen.org.apache.camel.eclipse,1,0,115,115,2,115.0
camel,org.apache.camel.component.aws2.bedrock.runtime.client.impl,2,103,12,115,4,57.5
camel,org.apache.camel.component.kubernetes.builds,2,97,18,115,3,57.5
camel,org.apache.camel.itest.osgi.core.mock,3,84,30,114,1,38.0
camel,org.apache.camel.component.mapstruct.dto,2,114,0,114,2,57.0
camel,org.apache.camel.itest.osgi.disruptor,4,92,22,114,1,28.5
camel,org.apache.camel.processor.throttle,5,61,53,114,17,22.8
camel,test.java.org.apache.camel.component.kameletreify,1,0,114,114,1,114.0
camel,test.java.org.foo.find.springboot,1,0,113,113,1,113.0
camel,test.java.org.apache.camel.component.aws.ses.integration,2,0,113,113,2,56.5
camel,test.java.org.apache.camel.component.dataformat,1,0,113,113,2,113.0
camel,test.java.org.apache.camel.component.mongodb.processor.idempotent,1,0,113,113,1,113.0
camel,test.java.org.apache.camel.component.google.calendar.stream,1,0,113,113,2,113.0
camel,org.apache.camel.test.main.junit5.custom,2,110,2,112,3,56.0
camel,org.apache.camel.example.jdbc,7,56,56,112,1,16.0
camel,test.java.org.apache.camel.component.braintree,1,0,112,112,1,112.0
camel,org.apache.camel.component.metrics.counter,3,24,88,112,5,37.333333333333336
camel,org.apache.camel.component.slack.utils,4,56,56,112,1,28.0
camel,org.apache.camel.itest.osgi.leveldb,3,107,5,112,1,37.333333333333336
camel,org.apache.camel.itest.osgi.core.timer,3,82,30,112,1,37.333333333333336
camel,org.apache.camel.language.property,12,81,31,112,5,9.333333333333334
camel,test.java.org.apache.camel.test.blueprint.cloud,1,0,112,112,2,112.0
camel,generated.java.org.apache.camel.component.aws2.ddb,1,0,112,112,2,112.0
camel,org.apache.camel.spring.issues.packagescan,8,98,13,111,2,13.875
camel,org.apache.camel.itest.standalone,8,81,30,111,1,13.875
camel,test.java.org.apache.camel.component.jasypt,1,0,111,111,3,111.0
camel,test.java.org.apache.camel.http.common,2,0,111,111,2,55.5
camel,org.apache.camel.component.wal.exceptions,1,111,0,111,3,111.0
camel,test.java.org.apache.camel.component.servlet,2,0,111,111,2,55.5
camel,test.java.playground,1,0,110,110,1,110.0
camel,playground,1,110,0,110,1,110.0
camel,org.apache.camel.spring.boot.fatjarroutertests,10,66,44,110,3,11.0
camel,generated.java.org.apache.camel.component.cxf,1,0,110,110,1,110.0
camel,org.apache.camel.web.htmlunit.pages,4,98,12,110,2,27.5
camel,test.java.org.apache.camel.component.cxf.phase,1,0,110,110,2,110.0
camel,org.apache.camel.component.restlet.route,9,84,26,110,1,12.222222222222221
camel,org.apache.camel.example.netty.cdi,7,55,55,110,1,15.714285714285714
camel,groovy.runtime.metaclass.org.apache.camel.model,2,55,55,110,1,55.0
camel,org.apache.camel.cdi.templatedroute,3,107,2,109,2,36.333333333333336
camel,test.java.org.apache.camel.catalog.karaf,1,0,109,109,1,109.0
camel,org.apache.camel.spring.debug,8,97,12,109,1,13.625
camel,test.java.org.apache.camel.component.jhc,1,0,109,109,1,109.0
camel,org.apache.camel.swagger.producer,18,50,59,109,3,6.055555555555555
camel,org.apache.camel.component.grpc.client.auth.jwt,1,109,0,109,2,109.0
camel,test.java.org.apache.camel.component.cxf.spring,1,0,109,109,2,109.0
camel,org.apache.camel.language.header,13,78,31,109,4,8.384615384615385
camel,test.java.org.apache.camel.example.artemis.amqp,1,0,109,109,2,109.0
camel,org.apache.camel.itest.osgi.core.dataformat,3,106,2,108,2,36.0
camel,org.apache.camel.component.swing,3,102,6,108,2,36.0
camel,test.java.org.apache.camel.component.milo.client,1,0,108,108,1,108.0
camel,org.apache.camel.component.bonita.consumer,3,54,54,108,1,36.0
camel,org.apache.camel.itest.osgi.dozer.model,2,106,2,108,2,54.0
camel,test.java.org.apache.camel.builder.xml,2,0,108,108,2,54.0
camel,test.java.org.apache.camel.component.quickfixj.examples.routing,1,0,107,107,1,107.0
camel,org.apache.camel.example.cdi.one.jbossas,1,107,0,107,1,107.0
camel,test.java.org.apache.camel.example.cdi.one.jbossas,1,0,107,107,1,107.0
camel,test.resources.org.apache.camel.main.java,1,107,0,107,4,107.0
camel,org.apache.camel.converter.dozer.dto,4,104,3,107,2,26.75
camel,test.java.org.apache.camel.test.testcontainers.junit5,2,0,106,106,2,53.0
camel,test.java.org.apache.camel.itest.osgi.syslog,1,0,106,106,1,106.0
camel,test.java.org.apache.camel.test.testcontainers,2,0,106,106,2,53.0
camel,test.java.org.apache.camel.test.infra.aws.common,1,0,106,106,3,106.0
camel,org.apache.camel.test.infra.dispatch.router.services,9,87,19,106,1,11.777777777777779
camel,test.java.org.apache.camel.component.jms.temp,2,0,106,106,2,53.0
camel,test.java.org.apache.camel.cdi.templatedroute,1,0,105,105,2,105.0
camel,org.apache.camel.dataformat.bindy.number,1,105,0,105,1,105.0
camel,test.java.org.apache.camel.processor.exceptionpolicy,1,0,105,105,1,105.0
camel,org.apache.camel.component.metrics.timer,3,24,81,105,5,35.0
camel,org.apache.camel.test.blueprint.component.restbinding,2,101,4,105,2,52.5
camel,org.apache.camel.dataformat.bindy.model.unicode,3,103,2,105,1,35.0
camel,org.apache.camel.itest.osgi.core.clazz,3,76,29,105,1,35.0
camel,org.apache.camel.test.main.junit5.common,1,103,2,105,6,105.0
camel,org.apache.camel.component.stream.mock,5,97,8,105,2,21.0
camel,test.java.org.apache.camel.component.pulsar.utils,1,0,105,105,1,105.0
camel,test.java.org.apache.camel.processor.routingslip,1,0,105,105,2,105.0
camel,test.java.org.apache.camel.core.osgi.other,1,0,105,105,2,105.0
camel,org.apache.camel.spring.boot.componentroute,5,98,7,105,2,21.0
camel,test.java.org.apache.camel.itest.osgi.core.dataformat,1,0,104,104,2,104.0
camel,test.java.org.apache.camel.component.jmx,1,0,104,104,1,104.0
camel,org.apache.camel.example.olingo4.blueprint,4,52,52,104,1,26.0
camel,org.apache.camel.itest.test,10,88,16,104,1,10.4
camel,test.java.org.apache.camel.component.jgroups.cluster,1,0,104,104,1,104.0
camel,test.java.org.apache.camel.itest.osgi.dozer.model,1,0,104,104,2,104.0
camel,org.apache.camel.component.kamelet.utils.serialization.kafka,2,99,5,104,1,52.0
camel,org.apache.camel.language.juel.issues,8,92,12,104,1,13.0
camel,org.apache.camel.spring.javaconfig.examples,1,104,0,104,2,104.0
camel,org.apache.camel.cdi.mock,6,87,17,104,1,17.333333333333332
camel,org.apache.camel.component.es.aggregation,4,97,7,104,5,26.0
camel,org.apache.camel.example.pojo,3,9,94,103,3,34.333333333333336
camel,org.apache.camel.component.atmos.integration,5,73,30,103,1,20.6
camel,org.apache.camel.guice.consume,7,86,17,103,1,14.714285714285714
camel,org.apache.camel.spi.management,3,18,85,103,7,34.333333333333336
camel,org.apache.camel.spring.config.scan.component,5,67,36,103,1,20.6
camel,org.apache.camel.opentracing.integration,4,96,7,103,2,25.75
camel,test.java.org.apache.camel.converter.myconverter,2,0,103,103,2,51.5
camel,test.java.org.apache.camel.example.cdi.xml,1,0,102,102,1,102.0
camel,test.java.org.apache.camel.component.splunkhec,1,0,102,102,1,102.0
camel,org.apache.camel.spring.endpoint,1,102,0,102,2,102.0
camel,org.apache.camel.component.xchange.market,11,55,47,102,2,9.272727272727273
camel,org.apache.camel.component.neo4j.transformer,3,98,4,102,2,34.0
camel,test.java.org.apache.camel.itest.osgi.leveldb,1,0,102,102,1,102.0
camel,org.apache.camel.dataformat.bindy.model.tab,5,96,6,102,1,20.4
camel,test.java.org.apache.camel.component.jbpm,1,0,101,101,1,101.0
camel,test.java.org.apache.camel.component.jgroups,2,0,101,101,2,50.5
camel,test.java.org.apache.camel.component.rocketmq.infra,1,0,101,101,1,101.0
camel,test.java.org.apache.camel.component.springldap,1,0,101,101,1,101.0
camel,org.apache.camel.component.rocketmq.infra,1,101,0,101,1,101.0
camel,test.java.org.apache.camel.opentracing.decorators,2,0,101,101,2,50.5
camel,test.java.org.apache.camel.converter.dozer.dto,1,0,101,101,2,101.0
camel,org.apache.camel.component.aws2.firehose.client,6,91,9,100,2,16.666666666666668
camel,org.apache.camel.component.kubernetes.build_configs,2,91,9,100,3,50.0
camel,org.apache.camel.support.sql,3,50,50,100,1,33.333333333333336
camel,org.apache.camel.itest.osgi.spring.bean,3,71,29,100,1,33.333333333333336
camel,org.apache.camel.component.spring.security.converter,2,87,13,100,3,50.0
camel,org.apache.camel.component.infinispan.remote.spring,5,63,37,100,8,20.0
camel,test.java.org.apache.camel.itest.osgi.hawtdb,1,0,100,100,1,100.0
camel,org.apache.camel.seda,3,95,4,99,3,33.0
camel,test.java.org.apache.camel.component.aws2.eventbridge.localstack,1,0,99,99,1,99.0
camel,test.java.org.apache.camel.main.xml,1,0,99,99,1,99.0
camel,test.java.org.apache.camel.example.cdi.one.weld,1,0,98,98,1,98.0
camel,org.apache.camel.converter.dozer.service,3,94,4,98,1,32.666666666666664
camel,org.apache.camel.component.opensearch.aggregation,4,96,2,98,3,24.5
camel,test.java.org.apache.camel.component.mybatis,2,0,98,98,2,49.0
camel,org.apache.camel.json.simple,4,94,4,98,1,24.5
camel,test.java.org.apache.camel.component.azure.servicebus,1,0,98,98,1,98.0
camel,org.apache.camel.component.mongodb.conf,3,89,9,98,2,32.666666666666664
camel,org.apache.camel.spring.interceptor.route,9,70,28,98,1,10.88888888888889
camel,org.apache.camel.dataformat.xmljson.converters,3,49,49,98,1,32.666666666666664
camel,test.java.org.apache.camel.itest.osgi.core.management,1,0,97,97,1,97.0
camel,org.apache.camel.component.aws2.sqs.client,8,88,8,96,4,12.0
camel,org.apache.camel.component.aws2.mq.client,7,89,7,96,2,13.714285714285714
camel,test.java.org.apache.camel.component.swing,1,0,96,96,2,96.0
camel,org.apache.camel.component.grpc.server.auth.jwt,1,96,0,96,1,96.0
camel,test.java.org.apache.camel.component.file.watch,1,0,96,96,2,96.0
camel,org.apache.camel.component.infinispan.embedded.spring,3,75,21,96,4,32.0
camel,test.java.org.apache.camel.openapi,1,0,96,96,1,96.0
camel,test.java.org.apache.camel.jms,1,0,96,96,1,96.0
camel,org.apache.camel.component.hystrix.metrics.servlet,4,48,48,96,1,24.0
camel,org.apache.camel.component.aws2.cw.client,6,89,7,96,2,16.0
camel,org.apache.camel.opentelemetry.propagators,9,81,14,95,2,10.555555555555555
camel,test.java.org.apache.camel.component.cxf.util,2,0,95,95,2,47.5
camel,test,2,44,51,95,2,47.5
camel,org.apache.camel.component.infinispan.remote.transform,1,95,0,95,1,95.0
camel,test.java.org.apache.camel.itest.osgi.core.language,1,0,95,95,2,95.0
camel,org.apache.camel.component.cron.api,1,95,0,95,2,95.0
camel,org.apache.camel.component.aws2.ses.integration,6,78,17,95,2,15.833333333333334
camel,org.apache.camel.itest.osgi.disruptor.vm,4,90,5,95,1,23.75
camel,test.java.org.apache.camel.component.jpa,2,0,94,94,2,47.0
camel,org.apache.camel.component.aws2.msk.client,6,88,6,94,2,15.666666666666666
camel,org.apache.camel.component.aws2.ddbstream.client,6,88,6,94,2,15.666666666666666
camel,org.apache.camel.processor.validator,8,50,44,94,9,11.75
camel,org.apache.camel.guice.testing.junit4,2,92,2,94,1,47.0
camel,org.apache.camel.component.rabbitmq.integration.qpid,2,50,44,94,9,47.0
camel,org.apache.camel.component.cmis.osgi,4,47,47,94,1,23.5
camel,test.java.org.apache.camel.component.aws2.ec2,1,0,94,94,1,94.0
camel,org.apache.camel.component.aws2.eks.client,6,88,6,94,2,15.666666666666666
camel,org.apache.camel.component.aws2.kms.client,6,88,6,94,2,15.666666666666666
camel,sample.opentracing.logging,3,47,47,94,1,31.333333333333332
camel,org.apache.camel.dataformat.bindy.model.padding,3,72,21,93,1,31.0
camel,org.apache.camel.dataformat.csv.main,1,93,0,93,2,93.0
camel,org.apache.camel.component.schematron.util,5,73,20,93,1,18.6
camel,test.java.org.apache.camel.component.aws2.kms,1,0,93,93,1,93.0
camel,test.java.org.apache.camel.component.smb,1,0,93,93,1,93.0
camel,test.java.org.apache.camel.opentracing.agent,1,0,93,93,1,93.0
camel,test.java.org.apache.camel.component.aws2.iam,1,0,93,93,1,93.0
camel,test.java.org.apache.camel.processor.juel,1,0,93,93,1,93.0
camel,org.apache.camel.catalog.common,1,62,31,93,2,93.0
camel,test.java.org.apache.camel.component.aws2.lambda,1,0,93,93,1,93.0
camel,test.java.org.apache.camel.component.aws2.mq,1,0,93,93,1,93.0
camel,org.apache.camel.util.xml.pretty,3,70,23,93,2,31.0
camel,test.java.org.apache.camel.component.validator.relaxng,1,0,93,93,1,93.0
camel,org.apache.camel.component.jms.integration.spring.issues,4,52,41,93,8,23.25
camel,test.java.org.apache.camel.component.aws2.athena,1,0,93,93,1,93.0
camel,org.apache.camel.component.caffeine.resume.single,1,93,0,93,1,93.0
camel,test.java.org.apache.camel.component.aws2.msk,1,0,93,93,1,93.0
camel,test.java.org.apache.camel.component.atomix.client.messaging,1,0,93,93,1,93.0
camel,test.java.org.apache.camel.component.aws.translate.integration,1,0,92,92,1,92.0
camel,org.malicious.example,2,92,0,92,2,46.0
camel,test.java.org.apache.camel.component.jetty9,1,0,92,92,1,92.0
camel,test.java.org.apache.camel.component.sip,1,0,92,92,1,92.0
camel,org.apache.camel.component.aws2.athena.client,5,87,5,92,2,18.4
camel,test.java.org.apache.camel.language.jq,1,0,92,92,1,92.0
camel,org.apache.camel.component.aws2.ec2.client,5,87,5,92,2,18.4
camel,org.apache.camel.component.aws2.ses.client,5,87,5,92,2,18.4
camel,org.apache.camel.component.aws2.ddb.client,5,87,5,92,2,18.4
camel,org.apache.camel.component.aws2.ecs.client,5,87,5,92,2,18.4
camel,org.apache.camel.component.aws2.eventbridge.client,5,87,5,92,2,18.4
camel,org.apache.camel.component.aws2.lambda.client,5,87,5,92,2,18.4
camel,org.apache.camel.dataformat.jibx.model,4,79,13,92,2,23.0
camel,org.apache.camel.component.aws2.translate.client,6,86,6,92,2,15.333333333333334
camel,test.java.org.apache.camel.component.sjms,1,0,92,92,1,92.0
camel,org.apache.camel.component.aws.secretsmanager.client,6,86,6,92,2,15.333333333333334
camel,org.apache.camel.example.webhook,2,46,46,92,1,46.0
camel,org.apache.camel.guice.patterns,6,85,7,92,1,15.333333333333334
camel,test.java.org.apache.camel.component.aws2.cw,1,0,91,91,1,91.0
camel,org.apache.camel.scr.internal,4,52,39,91,1,22.75
camel,org.example.client,1,91,0,91,2,91.0
camel,generated.java.org.apache.camel.component.etcd.cloud,1,0,91,91,1,91.0
camel,test.java.org.apache.camel.component.aws2.kinesis,1,0,91,91,1,91.0
camel,test.java.org.apache.camel.itest.osgi.servlet.support,1,0,91,91,1,91.0
camel,test.java.org.apache.camel.component.aws2.firehose,1,0,91,91,1,91.0
camel,org.apache.camel.component.redis.integration,4,59,32,91,3,22.75
camel,test.java.org.apache.camel.spring.boot.componentroute,1,0,91,91,2,91.0
camel,org.apache.camel.dataformat.bindy.fixed.unmarshall.simple.trim,12,52,39,91,1,7.583333333333333
camel,org.apache.camel.component.aws2.bedrock.client,2,86,4,90,2,45.0
camel,test.java.org.apache.camel.converter.dozer.service,1,0,90,90,1,90.0
camel,generated.java.org.apache.camel.component.torchserve,1,0,90,90,1,90.0
camel,org.apache.camel.component.aws2.iam.integration,5,45,45,90,7,18.0
camel,org.apache.camel.example.karaf.tika.parse,2,45,45,90,1,45.0
camel,test.java.org.apache.camel.component.aws2.sns,1,0,90,90,1,90.0
camel,org.apache.camel.component.aws2.sns.client,5,85,5,90,4,18.0
camel,org.apache.camel.component.jooq.beans,5,85,5,90,2,18.0
camel,test.java.org.apache.camel.component.aws2.ses,1,0,90,90,1,90.0
camel,org.apache.camel.component.aws.cloudtrail.client,5,86,4,90,2,18.0
camel,org.apache.camel.component.springboot,2,45,45,90,1,45.0
camel,test.java.org.apache.camel.spring.interceptor,2,0,90,90,2,45.0
camel,test.java.org.apache.camel.component.spring.ws.util,2,0,90,90,1,45.0
camel,org.apache.camel.itest.mail,8,73,17,90,1,11.25
camel,test.java.org.apache.camel.guice.testing.junit4,1,0,90,90,1,90.0
camel,test.java.org.apache.camel.spring.boot.health,1,0,90,90,1,90.0
camel,org.apache.camel.component.metrics.meter,3,18,71,89,5,29.666666666666668
camel,org.apache.camel.component.metrics.histogram,3,18,71,89,5,29.666666666666668
camel,test.java.org.apache.camel.opentracing.integration,1,0,89,89,1,89.0
camel,main.resources.auto-configure,5,84,5,89,2,17.8
camel,org.apache.camel.dsl.jbang.core.common.exceptions,4,58,31,89,2,22.25
camel,org.apache.camel.component.mllp.support,2,88,1,89,1,44.5
camel,org.apache.camel.component.jms.integration.spring.tx.async,1,49,40,89,10,89.0
camel,test.java.org.apache.camel.component.stream.mock,1,0,89,89,2,89.0
camel,test.java.org.apache.camel.spi,1,0,89,89,1,89.0
camel,test.java.org.apache.camel.component.zookeeper.springboot.cluster,1,0,89,89,1,89.0
camel,net.javacrumbs.springws.test.helper,4,83,5,88,1,22.0
camel,test.java.org.apache.camel.itest.osgi.util.jsse,1,0,88,88,1,88.0
camel,org.apache.camel.urlhandler.custom,6,67,21,88,2,14.666666666666666
camel,test.java.org.apache.camel.web,1,0,88,88,1,88.0
camel,org.apache.camel.trait.message,4,83,5,88,2,22.0
camel,test.java.org.apache.camel.wsdl_first,1,0,88,88,2,88.0
camel,test.java.org.apache.camel.component.apns.spring,1,0,87,87,1,87.0
camel,org.apache.camel.oaipmh.model,2,80,7,87,1,43.5
camel,test.java.org.apache.camel.component.mllp.support,1,0,87,87,1,87.0
camel,org.apache.camel.component.aws2.sts.client,4,82,5,87,2,21.75
camel,test.java.org.apache.camel.example.camel.transport,1,0,87,87,1,87.0
camel,generated.java.org.apache.camel.component.etcd3.processor.aggregate,1,0,87,87,1,87.0
camel,test.java.org.apache.camel.example.cxf.jaxrs,1,0,87,87,1,87.0
camel,org.apache.camel.example.rss,3,43,43,86,1,28.666666666666668
camel,org.apache.camel.component.netty.http.util,2,43,43,86,1,43.0
camel,test.java.org.apache.camel.component.ode,1,0,86,86,2,86.0
camel,org.apache.camel.component.chatscript.utils,4,57,29,86,1,21.5
camel,test.java.org.apache.camel.tools.apt,1,0,86,86,1,86.0
camel,org.apache.camel.component.aws2.stepfunctions.client,2,84,2,86,2,43.0
camel,test.java.org.apache.camel.example.spring.boot.rest.jpa,1,0,86,86,1,86.0
camel,org.apache.camel.component.firebase.springboot,2,43,43,86,1,43.0
camel,test.java.org.apache.camel.component.azure.storage.datalake.component,1,0,86,86,1,86.0
camel,org.apache.camel.dataformat.bindy.model.simple.bool,3,69,17,86,1,28.666666666666668
camel,test.java.org.apache.camel.component.djl.training,1,0,86,86,1,86.0
camel,org.apache.camel.component.servlet.springboot.test,4,79,7,86,3,21.5
camel,test.java.org.apache.camel.web.htmlunit.pages,1,0,86,86,2,86.0
camel,test.java.org.apache.camel.itest.osgi.disruptor.vm,1,0,85,85,1,85.0
camel,org.apache.camel.language.simple.myconverter,2,83,2,85,2,42.5
camel,org.apache.camel.dataformat.bindy.model.fixed.link,1,85,0,85,2,85.0
camel,org.apache.camel.spring.managment,11,62,23,85,2,7.7272727272727275
camel,test.java.org.apache.camel.spring.debug,1,0,85,85,1,85.0
camel,test.java.org.apache.camel.itest.osgi.rss,1,0,85,85,1,85.0
camel,org.apache.camel.rest.spring,4,77,8,85,2,21.25
camel,test.java.org.apache.camel.component.firebase.provider,1,0,85,85,2,85.0
camel,org.apache.camel.example.java8,3,2,82,84,1,28.0
camel,test.java.org.apache.camel.tracing.decorators,2,0,84,84,2,42.0
camel,org.apache.camel.example.karaf.rest,2,42,42,84,1,42.0
camel,org.apache.camel.support.task.task,1,45,39,84,5,84.0
camel,org.apache.camel.component.gridfs.springboot,5,82,2,84,1,16.8
camel,test.java.org.apache.camel.dataformat.bindy.csv,1,0,84,84,1,84.0
camel,org.apache.camel.main.scan3,1,84,0,84,3,84.0
camel,generated.java.org.apache.camel.dataformat.swift.mx,1,0,84,84,2,84.0
camel,test.java.org.apache.camel.component.activemq.support,1,0,83,83,3,83.0
camel,org.apache.camel.component.aws2.bedrock.agentruntime.client,1,83,0,83,2,83.0
camel,org.apache.camel.itest.springboot.arquillian.container.jmx,2,81,2,83,2,41.5
camel,test.java.org.apache.camel.itest.osgi.core,1,0,83,83,2,83.0
camel,org.apache.kafka.clients.producer,3,81,2,83,1,27.666666666666668
camel,org.apache.camel.component.aws2.redshift.data.client,2,81,2,83,2,41.5
camel,org.apache.camel.component.aws2.timestream.client,1,83,0,83,2,83.0
camel,test.java.org.apache.camel.tests.partialclasspath,1,0,83,83,2,83.0
camel,test.java.org.apache.camel.component.hashicorp.vault.integration.operations,1,0,83,83,1,83.0
camel,org.apache.camel.component.aws2.bedrock.agent.client,1,83,0,83,2,83.0
camel,test.java.org.apache.camel.component.urlrewrite,1,0,83,83,1,83.0
camel,generated.java.org.apache.camel.component.ribbon.cloud,1,0,82,82,1,82.0
camel,org.apache.camel.spring.contextscan.normalorder,3,76,6,82,2,27.333333333333332
camel,org.apache.camel.spring.contextscan.reverseorder,3,76,6,82,2,27.333333333333332
camel,org.apache.camel.example.console,5,41,41,82,1,16.4
camel,org.apache.camel.spring.boot.parent,6,70,12,82,2,13.666666666666666
camel,test.java.org.apache.camel.component.resilience4j,1,0,82,82,2,82.0
camel,org.apache.camel.component.aws.config.client,2,82,0,82,2,41.0
camel,test.java.org.apache.camel.component.stub,1,0,82,82,1,82.0
camel,org.apache.kafka.clients.consumer,9,68,14,82,1,9.11111111111111
camel,my.routes,2,82,0,82,5,41.0
camel,test.java.org.apache.camel.component.stringtemplate,1,0,82,82,1,82.0
camel,org.apache.camel.component.kafka.consumer.support.interop,2,80,2,82,1,41.0
camel,org.apache.camel.component.caffeine.resume,4,63,18,81,1,20.25
camel,org.apache.camel.itest.osgi.groovy,7,34,47,81,1,11.571428571428571
camel,org.apache.camel.loanbroker.credit,5,8,72,80,2,16.0
camel,test.java.org.apache.camel.component.salesforce.api.utils,1,0,80,80,1,80.0
camel,org.apache.camel.component.aws2.textract.client,1,80,0,80,2,80.0
camel,test.java.org.apache.camel.component.minio.integration,1,0,80,80,1,80.0
camel,test.java.org.apache.camel.language.juel.issues,1,0,80,80,1,80.0
camel,test.java.org.apache.camel.component.consul,1,0,80,80,1,80.0
camel,test.java.org.apache.camel.dsl.xml.jaxb.definition.cdi,1,0,80,80,1,80.0
camel,org.apache.camel.component.micrometer.prometheus.internal,1,80,0,80,1,80.0
camel,org.apache.camel.itest.osgi.packages,3,77,3,80,2,26.666666666666668
camel,org.apache.camel.dsl.java.joor.support,1,80,0,80,2,80.0
camel,org.apache.camel.itest.osgi.jsch,4,70,10,80,1,20.0
camel,main.resources.archetype-resources.__artifactId__-component.src.main.java.internal,3,75,5,80,3,26.666666666666668
camel,test.java.org.apache.camel.component.sjms.manual,1,0,79,79,1,79.0
camel,org.apache.camel.spring.boot.example,1,79,0,79,2,79.0
camel,test.java.org.apache.camel.itest.springboot.arquillian.container.jmx,1,0,79,79,2,79.0
camel,test.java.org.apache.camel.spring.cloud.consul.support,1,0,79,79,2,79.0
camel,test.java.org.apache.camel.spring.boot.example,1,0,79,79,2,79.0
camel,test.java.org.apache.camel.component.http4.helper,1,0,79,79,1,79.0
camel,org.apache.camel.test.infra.azure.common,2,79,0,79,3,39.5
camel,test.java.org.apache.camel.component.dropbox,1,0,78,78,1,78.0
camel,org.apache.camel.component.kamelet.utils.kafka,1,78,0,78,1,78.0
camel,test.java.org.apache.camel.dsl.jbang.core.commands,1,0,78,78,1,78.0
camel,org.apache.camel.processor.aggregate.util,5,70,8,78,1,15.6
camel,test.java.org.apache.camel.component.vertx.http,1,0,78,78,1,78.0
camel,test.java.org.apache.camel.spring.file,1,0,78,78,1,78.0
camel,org.apache.camel.example.cdi.two.jbossas,1,78,0,78,1,78.0
camel,test.java.org.apache.camel.example.guice.jms,2,0,78,78,2,39.0
camel,test.java.org.apache.camel.example.cdi.two.jbossas,1,0,78,78,1,78.0
camel,test.java.org.apache.camel.guice.patterns,1,0,78,78,1,78.0
camel,test.java.org.apache.camel.component.iec60870.testing,1,0,77,77,1,77.0
camel,test.java.org.apache.camel.itest.osgi.ahc,1,0,77,77,1,77.0
camel,org.apache.camel.parser.roaster,4,39,38,77,4,19.25
camel,test.java.org.apache.camel.component.sjms2,1,0,76,76,1,76.0
camel,test.java.org.apache.camel.itest.osgi.http4,1,0,76,76,1,76.0
camel,org.apache.camel.component.aws2.bedrock.agentruntime.integration,2,72,4,76,1,38.0
camel,org.apache.camel.component.jbpm.config,4,38,38,76,1,19.0
camel,test.java.org.apache.camel.itest.osgi.dozer,1,0,76,76,1,76.0
camel,org.apache.camel.component.cxf.spring.jaxrs,4,64,12,76,7,19.0
camel,org.apache.camel.examples.jooq,2,38,38,76,1,38.0
camel,test.java.org.apache.camel.component.jetty.async,1,0,76,76,1,76.0
camel,org.apache.camel.component.zookeeper.integration,6,42,33,75,6,12.5
camel,org.apache.camel.component.rxjava2.engine.suport,2,74,1,75,1,37.5
camel,test.java.org.apache.camel.example.osgi,1,0,75,75,1,75.0
camel,test.java.org.apache.camel.component.platform.http.main,1,0,75,75,1,75.0
camel,test.java.org.apache.camel.component.atomix.ha,1,0,75,75,1,75.0
camel,org.apache.camel.component.azure.servicebus.transform,3,68,7,75,1,25.0
camel,test.java.org.apache.camel.component.nats.integration,1,0,75,75,1,75.0
camel,org.apache.camel.component.reactor.engine.suport,2,74,1,75,1,37.5
camel,test.java.org.apache.camel.builder.saxon,1,0,74,74,1,74.0
camel,test.java.org.apache.camel.itest.osgi.core.packages,1,0,74,74,2,74.0
camel,org.apache.camel.component.schematron.exception,3,71,3,74,2,24.666666666666668
camel,sample.service,3,37,37,74,1,24.666666666666668
camel,generated.java.org.apache.camel.component.elytron,1,0,74,74,2,74.0
camel,org.apache.camel.itest.jaxb.example,4,63,11,74,1,18.5
camel,org.apache.camel.reacitve,1,74,0,74,1,74.0
camel,org.apache.camel.component.fop.utils,1,74,0,74,2,74.0
camel,generated.java.org.apache.camel.component.hbase.converter,1,0,74,74,1,74.0
camel,main.resources.archetype-resources.__artifactId__-api.src.main.java,3,72,2,74,4,24.666666666666668
camel,test.java.org.apache.camel.example.cdi,1,0,73,73,1,73.0
camel,org.apache.camel.http.base.cookie,4,32,41,73,4,18.25
camel,org.apache.camel.spring.issues.componentscan,1,73,0,73,2,73.0
camel,org.apache.camel.spring.factory,4,62,11,73,1,18.25
camel,test.java.org.apache.camel.itest.osgi.jms,1,0,73,73,1,73.0
camel,test.java.org.apache.camel.component.fastjson.converter,1,0,73,73,1,73.0
camel,test.java.org.apache.camel.component.jsonb.converter,1,0,73,73,1,73.0
camel,test.java.org.apache.camel.component.gson.conversion,1,0,73,73,1,73.0
camel,test.java.org.apache.camel.component.direct,1,0,73,73,1,73.0
camel,test.java.org.apache.camel.script.osgi,1,0,73,73,1,73.0
camel,org.apache.camel.component.gson.conversion,1,73,0,73,1,73.0
camel,test.java.org.apache.camel.component.jetty.cloud,1,0,73,73,1,73.0
camel,test.java.org.apache.camel.web.spring,1,0,73,73,1,73.0
camel,org.apache.camel.spring.issues.componentscan2,1,73,0,73,2,73.0
camel,test.java.org.apache.camel.component.johnzon.converter,1,0,73,73,1,73.0
camel,test.java.library,1,0,72,72,1,72.0
camel,test.java.org.apache.camel.itest.osgi.restlet,1,0,72,72,1,72.0
camel,org.apache.camel.itest.karaf.bean,1,72,0,72,1,72.0
camel,org.apache.camel.spring.processor.intercept,5,52,20,72,1,14.4
camel,org.apache.camel.component.debug,9,46,26,72,2,8.0
camel,test.java.org.apache.camel.component.xslt.saxon,1,0,72,72,2,72.0
camel,test.java.org.apache.camel.language.groovy,1,0,72,72,1,72.0
camel,org.apache.camel.component.mongodb.gridfs.integration,10,36,36,72,3,7.2
camel,org.apache.camel.test.infra.ibmmq.common,1,72,0,72,2,72.0
camel,test.java.org.apache.camel.xbean,1,0,72,72,1,72.0
camel,test.java.org.apache.camel.itest.test,1,0,72,72,1,72.0
camel,test.java.org.apache.camel.itest.osgi.jasypt,1,0,72,72,1,72.0
camel,test.java.org.apache.camel.example.cdi.metrics,1,0,72,72,1,72.0
camel,test.java.org.apache.camel.component.plc4x,1,0,71,71,1,71.0
camel,test.java.org.apache.camel.itest.osgi.core.validator,1,0,71,71,1,71.0
camel,org.apache.camel.itest.osgi.validator,1,71,0,71,1,71.0
camel,test.java.org.apache.camel.example.cdi.properties,1,0,71,71,1,71.0
camel,test.java.org.apache.camel.rest.resources,1,0,71,71,1,71.0
camel,org.apache.camel.component.cxf.transport.util,1,71,0,71,1,71.0
camel,org.apache.camel.dataformat.bindy.model.simple.oneclassandtrimandclip,2,70,1,71,1,35.5
camel,test.java.org.apache.camel.spring.bind,1,0,70,70,1,70.0
camel,org.apache.camel.component.eclipse,3,35,35,70,1,23.333333333333332
camel,test.java.org.apache.camel.cdi.mock,1,0,70,70,1,70.0
camel,test.java.org.apache.camel.component.kubernetes.cluster.utils,1,0,70,70,1,70.0
camel,org.apache.camel.dataformat.bindy.model.simple.pipeline,5,64,6,70,1,14.0
camel,org.apache.camel.example.servlet,3,35,35,70,1,23.333333333333332
camel,test.java.org.apache.camel.spring.aop,1,0,70,70,1,70.0
camel,org.apache.camel.component.http4.cloud,5,66,4,70,4,14.0
camel,org.apache.camel.oaipmh.component.model,3,68,2,70,2,23.333333333333332
camel,test.java.org.apache.camel.itest.osgi.disruptor,1,0,70,70,1,70.0
camel,org.apache.camel.itest.karaf.issues,1,70,0,70,1,70.0
camel,test.java.org.apache.camel.component.kamelet,1,0,70,70,1,70.0
camel,test.java.org.apache.camel.test.infra.etcd3.services,1,0,69,69,2,69.0
camel,org.apache.camel.component.google.pubsublite.serializer,1,69,0,69,2,69.0
camel,test.java.org.apache.camel.guice.consume,1,0,69,69,1,69.0
camel,test.java.org.apache.camel.itest.nettyhttp,1,0,69,69,1,69.0
camel,test.java.org.apache.camel.component.amqp,1,0,69,69,1,69.0
camel,generated.java.org.apache.camel.dataformat.xstream,1,0,69,69,2,69.0
camel,test.java.org.apache.camel.itest.osgi.groovy,1,0,69,69,1,69.0
camel,org.apache.camel.component.gae.support,3,66,2,68,1,22.666666666666668
camel,org.apache.camel.component.google.calendar.integration,1,48,20,68,7,68.0
camel,org.apache.camel.component.file.azure.transform,3,62,6,68,1,22.666666666666668
camel,org.apache.camel.component.aws2.kinesis.transform,3,62,6,68,1,22.666666666666668
camel,org.apache.camel.component.azure.storage.queue.transform,6,63,5,68,1,11.333333333333334
camel,test.java.org.apache.camel.spring.processor.aggregator,1,0,68,68,1,68.0
camel,org.apache.camel.itest.osgi.spring.event,2,66,2,68,1,34.0
camel,org.apache.camel.component.servicenow.annotations,3,64,4,68,4,22.666666666666668
camel,org.apache.camel.processor.aggregate.jdbc.util,4,64,4,68,1,17.0
camel,org.foo.salesforce.contact,3,34,34,68,1,22.666666666666668
camel,org.foo.mention,3,34,34,68,1,22.666666666666668
camel,org.apache.camel.component.sql.support,3,67,1,68,1,22.666666666666668
camel,org.apache.camel.itest.osgi.mvel,2,64,3,67,1,33.5
camel,test.java.org.apache.camel.component.paho,1,0,67,67,1,67.0
camel,org.apache.camel.component.aws2.textract.integration,1,67,0,67,1,67.0
camel,test.java.org.apache.camel.component.sql.support,1,0,66,66,1,66.0
camel,test.java.org.apache.camel.component.milo.converter,1,0,66,66,1,66.0
camel,org.apache.camel.yaml.dsl.kamelet,1,66,0,66,1,66.0
camel,org.foo.search.springbot,1,65,0,65,1,65.0
camel,test.java.org.apache.camel.test.infra.ollama.services,1,0,65,65,1,65.0
camel,test.java.org.apache.camel.component.es,1,0,65,65,1,65.0
camel,test.resources.jbang.it,3,64,1,65,2,21.666666666666668
camel,generated.java.org.apache.camel.component.smb.converter,1,0,65,65,1,65.0
camel,test.java.org.apache.camel.component.paho.mqtt5,1,0,65,65,1,65.0
camel,test.java.org.apache.camel.component.opensearch,1,0,65,65,1,65.0
camel,org.apache.camel.component.slack.transform,2,62,2,64,1,32.0
camel,test.java.org.apache.camel.itest.osgi.core.ref,1,0,64,64,1,64.0
camel,test.java.org.apache.camel.component.consul.cluster,1,0,64,64,1,64.0
camel,org.apache.camel.component.azure.eventhubs.transform,3,60,4,64,1,21.333333333333332
camel,test.java.org.apache.camel.component.gae.support,1,0,64,64,1,64.0
camel,org.apache.camel.support.processor.state,4,40,24,64,4,16.0
camel,test.java.org.apache.camel.example.cdi.rest.servlet,1,0,64,64,1,64.0
camel,generated.java.org.apache.camel.component.elasticsearch.converter,1,0,64,64,1,64.0
camel,test.java.org.apache.camel.component.box.internal,1,0,64,64,1,64.0
camel,org.apache.camel.converter.jaxb.mapper,6,58,6,64,2,10.666666666666666
camel,org.apache.camel.component.dozer.example,3,61,3,64,2,21.333333333333332
camel,org.apache.camel.component.langchain4j.chat.rag,3,62,2,64,1,21.333333333333332
camel,test.java.org.apache.camel.dataformat.supercsv,1,0,64,64,1,64.0
camel,org.apache.camel.spring.cloud.zookeeper.support,2,63,1,64,1,32.0
camel,org.apache.camel.component.aws.cloudtrail.transform,4,60,4,64,1,16.0
camel,test.java.org.apache.camel.itest.osgi.spring.event,1,0,64,64,1,64.0
camel,org.apache.camel.spring.component,1,64,0,64,1,64.0
camel,org.apache.camel.component.knative.http.assertions,1,64,0,64,1,64.0
camel,org.apache.camel.example.karaf.models,2,32,32,64,1,32.0
camel,org.apache.camel.itest.osgi.core.vm,2,62,2,64,1,32.0
camel,org.apache.camel.component.avro.spi,1,64,0,64,2,64.0
camel,test.java.org.apache.camel.component.mock,1,0,63,63,1,63.0
camel,org.apache.camel.main.scan2,2,61,2,63,2,31.5
camel,org.apache.camel.support.language,7,32,31,63,4,9.0
camel,org.apache.camel.test.infra.azure.storage.queue.clients,1,63,0,63,1,63.0
camel,test.java.org.apache.camel.example.cxf.httptojms,1,0,63,63,1,63.0
camel,org.apache.camel.itest.osgi.dozer.service,2,62,1,63,1,31.5
camel,org.apache.camel.component.soroushbot,2,62,1,63,1,31.5
camel,test.java.org.apache.camel.component.freemarker,1,0,63,63,1,63.0
camel,org.apache.camel.component.google.calendar.transform,2,60,2,62,1,31.0
camel,test.java.org.apache.camel.spring.cloud.zookeeper.support,1,0,62,62,1,62.0
camel,test.java.org.apache.camel.component.servletlistener.routes,1,0,62,62,2,62.0
camel,org.apache.camel.component.servletlistener.routes,1,62,0,62,2,62.0
camel,org.apache.camel.avro.impl,7,55,7,62,2,8.857142857142858
camel,org.apache.camel.example.provider,6,55,7,62,1,10.333333333333334
camel,org.apache.camel.test.infra.keycloak,1,62,0,62,1,62.0
camel,test.java.org.apache.camel.itest.osgi.quartz,1,0,62,62,1,62.0
camel,org.apache.camel.component.aws2.ddbstream.transform,3,59,3,62,1,20.666666666666668
camel,test.java.org.foo,1,0,62,62,1,62.0
camel,org.apache.camel.test.blueprint.health,3,60,2,62,1,20.666666666666668
camel,test.java.org.apache.camel.itest.osgi.netty,1,0,62,62,1,62.0
camel,org.apache.camel.component.gson.annotation,3,58,4,62,2,20.666666666666668
camel,test.java.org.apache.camel.example.cdi.two.weld,1,0,62,62,1,62.0
camel,test.java.org.apache.camel.itest.osgi.mina,1,0,62,62,1,62.0
camel,org.apache.camel.language.variable,2,55,7,62,1,31.0
camel,org.apache.camel.component.mapstruct.mapper,2,62,0,62,2,31.0
camel,org.apache.camel.component.jms.integration.issues,2,39,23,62,9,31.0
camel,org.apache.camel.component.zookeeper.operations.integration,3,37,24,61,7,20.333333333333332
camel,test.java.org.apache.camel.component.salesforce.api,1,0,61,61,1,61.0
camel,test.java,1,61,0,61,1,61.0
camel,org.apache.camel.component.google.mail.stream.transform,2,59,2,61,1,30.5
camel,test.java.org.apache.camel.dsl.jsh,1,0,61,61,1,61.0
camel,test.java.org.apache.camel.dataformat.bindy.model.csv,1,0,61,61,1,61.0
camel,test.java.org.apache.camel.itest.osgi.exec,1,0,61,61,1,61.0
camel,test.java.org.apache.camel.component.aws2.cw.integration,1,0,61,61,1,61.0
camel,org.apache.camel.component.hdfs.osgi,3,5,56,61,1,20.333333333333332
camel,org.apache.camel.test.infra.solr.common,3,59,2,61,2,20.333333333333332
camel,test.java.org.apache.camel.spring.boot.duplicatedrouteid,1,0,61,61,1,61.0
camel,test.java.org.apache.camel.itest.osgi.dozer.service,1,0,61,61,1,61.0
camel,test.java.org.apache.camel.component.docker.util,1,0,61,61,1,61.0
camel,test.java.org.apache.camel.component.soroushbot,1,0,61,61,1,61.0
camel,test.java.org.apache.camel.itest.osgi.mvel,1,0,61,61,1,61.0
camel,org.apache.camel.test.infra.azure.storage.blob.clients,1,61,0,61,1,61.0
camel,test.java.org.apache.camel.component.atmos.integration.consumer,1,0,61,61,1,61.0
camel,test.java.org.apache.camel.component.lumberjack,1,0,60,60,1,60.0
camel,test.java.org.apache.camel.itest.osgi.jsch,1,0,60,60,1,60.0
camel,org.apache.camel.component.google.pubsub.transform,2,58,2,60,1,30.0
camel,org.apache.camel.component.atomix.springboot,3,30,30,60,1,20.0
camel,org.apache.camel.itest.osgi.mail,9,29,31,60,1,6.666666666666667
camel,test.java.org.apache.camel.itest.osgi.stream,1,0,60,60,1,60.0
camel,org.apache.camel.itest.karaf.converters,1,60,0,60,1,60.0
camel,org.apache.camel.component.mongodb.meta.integration,9,28,32,60,1,6.666666666666667
camel,org.apache.camel.component.azure.storage.datalake.transform,2,58,2,60,1,30.0
camel,org.apache.camel.web.spring,11,32,28,60,1,5.454545454545454
camel,test.java.org.apache.camel.component.util,1,0,60,60,1,60.0
camel,test.java.org.apache.camel.itest.osgi.core.vm,1,0,60,60,1,60.0
camel,org.apache.camel.dsl.yaml.deserializers.model,1,60,0,60,1,60.0
camel,test.java.org.apache.camel.example.management,1,0,60,60,1,60.0
camel,generated.java.org.apache.camel.component.gson.converter,1,0,59,59,1,59.0
camel,generated.java.org.apache.camel.component.jsonb.converter,1,0,59,59,1,59.0
camel,test.java.org.apache.camel.component.sjms.consumer,1,0,59,59,1,59.0
camel,it.customized.src.main.java.com.example,2,0,59,59,2,29.5
camel,org.apache.camel.component.thrift.client,4,54,5,59,1,14.75
camel,org.apache.camel.test.main.junit5.annotation.other,1,59,0,59,2,59.0
camel,generated.java.org.apache.camel.component.fastjson.converter,1,0,59,59,1,59.0
camel,generated.java.org.apache.camel.component.johnzon.converter,1,0,59,59,1,59.0
camel,test.java.org.apache.camel.itest.osgi.core.dataset,1,0,59,59,1,59.0
camel,org.apache.camel.component.salesforce.api.dto.pubsub,1,59,0,59,1,59.0
camel,org.apache.camel.component.salesforce.internal.dto.composite,3,55,3,58,1,19.333333333333332
camel,test.java.org.apache.camel.component.twitter.directmessage,1,0,58,58,2,58.0
camel,org.apache.camel.component.http.cloud,5,49,9,58,3,11.6
camel,test.java.org.apache.camel.component.restlet.route,1,0,58,58,1,58.0
camel,test.java.org.apache.camel.spring.boot.parent,1,0,58,58,1,58.0
camel,test.java.org.apache.camel.management.util,1,0,58,58,1,58.0
camel,test.java.org.apache.camel.component.dozer.example,1,0,58,58,2,58.0
camel,com.google.appengine.api.labs.taskqueue,2,57,1,58,1,29.0
camel,org.apache.camel.dataformat.bindy.model.fix.sorted.trailer,6,51,7,58,1,9.666666666666666
camel,test.java.org.apache.camel.spring.management,1,0,58,58,1,58.0
camel,test.java.org.apache.camel.component.twitter.timeline,1,0,58,58,2,58.0
camel,test.java.org.apache.camel.test.blueprint.health,1,0,58,58,1,58.0
camel,org.apache.camel.component.azure.cosmosdb.transform,2,55,2,57,1,28.5
camel,org.apache.camel.component.kafka.testutil,1,57,0,57,1,57.0
camel,org.apache.camel.osgi.converter,1,57,0,57,1,57.0
camel,test.java.com.google.appengine.api.urlfetch,1,0,57,57,1,57.0
camel,test.java.org.apache.camel.test.infra.qdrant.services,1,0,57,57,1,57.0
camel,org.apache.camel.component.kamelet.utils.djl,1,57,0,57,1,57.0
camel,org.apache.camel.dataformat.csv.converter,5,51,6,57,1,11.4
camel,com.google.appengine.api.urlfetch,1,57,0,57,1,57.0
camel,generated.java.org.apache.camel.component.spring.integration.converter,1,0,56,56,1,56.0
camel,test.java.org.apache.camel.itest.osgi.management,1,0,56,56,1,56.0
camel,test.java.com.google.appengine.api.labs.taskqueue,1,0,56,56,1,56.0
camel,test.java.org.apache.camel.component.hawtdb.util,1,0,56,56,1,56.0
camel,test.java.org.apache.camel.component.etcd3.support,1,0,56,56,1,56.0
camel,test.java.org.apache.camel.itest.mail,1,0,56,56,1,56.0
camel,test.java.org.apache.camel.component.xmlrpc.converter,1,0,56,56,1,56.0
camel,org.apache.camel.component.smooks.routing.gender,1,56,0,56,2,56.0
camel,test.java.org.apache.camel.component.dropbox.integration.consumer,1,0,56,56,1,56.0
camel,org.apache.camel.component.hawtdb.util,1,56,0,56,1,56.0
camel,org.apache.camel.component.etcd3.support,1,56,0,56,1,56.0
camel,org.apache.camel.itest.osgi.core,3,48,7,55,2,18.333333333333332
camel,org.apache.camel.component.kamelet.utils.format,1,55,0,55,1,55.0
camel,test.java.org.apache.camel.component.splunk.integration,1,0,55,55,1,55.0
camel,test.java.org.apache.camel.itest.osgi.core.browse,1,0,55,55,1,55.0
camel,org.apache.camel.spring.impl.transformer,5,53,2,55,1,11.0
camel,test.java.org.apache.camel.component.infinispan.util,1,0,55,55,1,55.0
camel,org.apache.camel.component.jgroups.raft.utils,3,51,4,55,1,18.333333333333332
camel,org.apache.camel.converter.soap.name.testpackage,4,49,6,55,2,13.75
camel,org.apache.camel.support.console,5,31,24,55,1,11.0
camel,test.java.org.apache.camel.itest.customerrelations,1,0,54,54,1,54.0
camel,test.java.org.apache.camel.component.vertx.websocket,1,0,54,54,1,54.0
camel,test.java.org.apache.camel.dataformat.parquet.avro,1,0,54,54,1,54.0
camel,test.java.org.apache.camel.example.springboot.geocoder,1,0,54,54,1,54.0
camel,test.java.org.apache.camel.component.validator.msv,1,0,54,54,1,54.0
camel,test.java.org.apache.camel.itest.osgi.core.mock,1,0,54,54,1,54.0
camel,test.java.org.apache.camel.example.pojo,1,0,54,54,1,54.0
camel,generated.java.org.apache.camel.component.milo.converter,1,0,54,54,1,54.0
camel,org.myfoo.connector,2,27,27,54,1,27.0
camel,test.java.org.apache.camel.karaf.commands,1,0,53,53,1,53.0
camel,test.java.org.apache.camel.spring.boot.actuate.info,1,0,53,53,1,53.0
camel,test.java.org.apache.camel.cdi.component.properties,1,0,53,53,1,53.0
camel,org.apache.camel.itest.osgi.xslt,1,53,0,53,1,53.0
camel,org.apache.camel.component.hazelcast.testutil,2,51,2,53,1,26.5
camel,generated.java.org.apache.camel.component.jira,1,0,52,52,1,52.0
camel,test.java.org.apache.camel.itest.osgi.core.timer,1,0,52,52,1,52.0
camel,org.apache.camel.test.infra.etcd3.common,2,26,26,52,2,26.0
camel,test.java.org.apache.camel.commands.internal,1,0,52,52,1,52.0
camel,test.java.org.apache.camel.catalog,1,0,52,52,1,52.0
camel,test.java.org.apache.camel.itest.jaxb.example,1,0,52,52,1,52.0
camel,org.apache.camel.component.jcache.support,3,50,2,52,1,17.333333333333332
camel,generated.java.org.apache.camel.component.atomix,1,0,52,52,1,52.0
camel,test.java.org.apache.camel.component.arangodb.integration,1,0,52,52,1,52.0
camel,test.java.org.apache.camel.component.salesforce.springboot,1,0,52,52,1,52.0
camel,org.apache.camel.support.task.budget.backoff,3,48,4,52,2,17.333333333333332
camel,test.java.org.apache.camel.component.twitter.streaming,1,0,52,52,2,52.0
camel,org.apache.camel.eclipse.editor,3,26,26,52,2,17.333333333333332
camel,test.java.org.apache.camel.itest.standalone,1,0,51,51,1,51.0
camel,org.apache.camel.component.bonita.exception,3,41,10,51,1,17.0
camel,org.apache.camel.testng.example,2,50,1,51,1,25.5
camel,test.java.org.apache.camel.component.gora.utils,1,0,51,51,1,51.0
camel,test.java.org.apache.camel.component.jms.config,1,0,51,51,1,51.0
camel,org.apache.camel.impl.scan.test.c,1,51,0,51,2,51.0
camel,test.java.org.apache.camel.itest.osgi.core.properties,1,0,51,51,1,51.0
camel,org.apache.camel.component.quickfix.example,6,45,6,51,2,8.5
camel,org.apache.camel.spring.issues.contextscan3,7,45,6,51,2,7.285714285714286
camel,org.apache.camel.component.google.mail.integration,1,35,15,50,5,50.0
camel,test.java.org.apache.camel.component.langchain.embeddings,1,0,50,50,1,50.0
camel,test.java.org.apache.camel.itest.osgi.core.seda,1,0,50,50,1,50.0
camel,test.java.org.apache.camel.impl.engine,1,0,50,50,1,50.0
camel,org.apache.camel.impl.scan.test,1,50,0,50,2,50.0
camel,test.java.org.apache.camel.component.hazelcast.policy,1,0,50,50,1,50.0
camel,org.apache.camel.itest.spring31,2,49,1,50,1,25.0
camel,org.apache.camel.component.quickfixj.examples.util,5,46,4,50,1,10.0
camel,generated.java.org.apache.camel.component.http,1,0,50,50,1,50.0
camel,test.java.org.apache.camel.testng.example,1,0,49,49,1,49.0
camel,generated.java.org.apache.camel.impl.console,1,0,49,49,1,49.0
camel,test.java.org.apache.camel.component.influxdb,1,0,49,49,1,49.0
camel,test.java.org.apache.camel.component.etcd.policy,1,0,49,49,1,49.0
camel,test.java.org.apache.camel.component.consul.policy,1,0,48,48,1,48.0
camel,org.foo.find,3,9,39,48,1,16.0
camel,org.apache.camel.component.huaweicloud.common.models,4,33,15,48,2,12.0
camel,test.java.org.apache.camel.example.provider,1,0,48,48,1,48.0
camel,test.java.org.apache.camel.itest.spring31,1,0,48,48,1,48.0
camel,test.java.org.apache.camel.itest.osgi.core.direct,1,0,48,48,1,48.0
camel,test.java.org.apache.camel.component.facebook.config,1,0,48,48,1,48.0
camel,test.java.org.apache.camel.example.spring.boot,1,0,48,48,1,48.0
camel,test.java.org.apache.camel.camel_dynamicep,1,0,48,48,1,48.0
camel,generated.java.org.apache.camel.component.influxdb2.converters,1,0,48,48,1,48.0
camel,io.fabric,1,48,0,48,1,48.0
camel,org.apache.camel.itest.spring40,1,48,0,48,1,48.0
camel,org.apache.camel.camel_dynamicep,1,48,0,48,1,48.0
camel,org.apache.camel.itest.spring32,1,48,0,48,1,48.0
camel,test.java.org.apache.camel.itest.spring40,1,0,48,48,1,48.0
camel,test.java.org.apache.camel.itest.spring32,1,0,48,48,1,48.0
camel,test.java.org.apache.camel.component.snakeyaml,1,0,47,47,1,47.0
camel,org.apache.camel.component.drill.util,2,45,2,47,1,23.5
camel,test.java.org.apache.camel.dsl.jbang.core.commands.kubernetes,1,0,47,47,1,47.0
camel,org.apache.camel.component.google.secret.manager.unit,2,47,0,47,1,23.5
camel,test.java.org.apache.camel.itest.osgi.core.clazz,1,0,47,47,1,47.0
camel,org.apache.camel.test.infra.docling,1,46,0,46,1,46.0
camel,org.apache.camel.component.chronicle,2,23,23,46,1,23.0
camel,org.apache.camel.component.aws2.sts.integration,6,24,22,46,4,7.666666666666667
camel,generated.java.org.apache.camel.converter.stream,1,0,46,46,1,46.0
camel,org.apache.camel.dsl.xml.jaxb.spring,4,20,26,46,1,11.5
camel,examples,2,28,18,46,1,23.0
camel,test.java.org.apache.camel.component.hdfs2,1,0,46,46,1,46.0
camel,test.java.org.apache.camel.component.etcd,1,0,46,46,1,46.0
camel,org.apache.camel.component.zookeeper.cluster.integration,5,23,23,46,3,9.2
camel,test.java.org.beverage,1,0,46,46,1,46.0
camel,org.apache.camel.component.kamelet.utils.transform.aws2.ddb,1,46,0,46,1,46.0
camel,org.apache.camel.test.infra.cli.common,5,46,0,46,1,9.2
camel,org.apache.camel.test.infra.azure.storage.datalake.clients,1,45,0,45,1,45.0
camel,org.apache.camel.tooling.maven.support,6,36,9,45,3,7.5
camel,org.apache.camel.component.docker.ssl,5,42,3,45,1,9.0
camel,test.java.org.apache.camel.component.salesforce.dto.generated,1,0,45,45,1,45.0
camel,test.java.org.apache.camel.processor.idempotent.kafka,1,0,45,45,1,45.0
camel,org.apache.camel.component.jms.integration.activemq,2,25,20,45,6,22.5
camel,org.apache.camel.itest.osgi.core.management,8,21,24,45,1,5.625
camel,org.apache.camel.component.wordpress.proxy,3,43,2,45,1,15.0
camel,test.integration.org.apache.camel,1,0,44,44,1,44.0
camel,org.apache.camel.itest.spring30,2,43,1,44,1,22.0
camel,org.apache.camel.spring.impl.validator,6,39,5,44,1,7.333333333333333
camel,test.java.org.apache.camel.component.atomix,1,0,44,44,1,44.0
camel,org.apache.camel.blueprint.test.builder,3,37,7,44,1,14.666666666666666
camel,test.java.org.apache.camel.converter.soap.name,1,0,44,44,1,44.0
camel,org.apache.camel.itest.osgi.core.seda,7,16,28,44,1,6.285714285714286
camel,test.java.org.apache.camel.maven.packaging.model,1,0,44,44,1,44.0
camel,org.apache.camel.test.blueprint.scan,3,37,7,44,1,14.666666666666666
camel,test.java.org.apache.camel.component.aws.common,1,0,44,44,1,44.0
camel,test.java.org.apache.camel.component.atmosphere.websocket,1,0,44,44,1,44.0
camel,org.apache.camel.component.properties.route,6,36,8,44,1,7.333333333333333
camel,org.apache.camel.component.schematron.constant,4,41,2,43,1,10.75
camel,test.java.org.apache.camel.component.atmos.integration,1,0,43,43,1,43.0
camel,org.apache.camel.component.aws2.cw.integration,9,22,21,43,3,4.777777777777778
camel,org.apache.camel.component.grape.springboot,1,43,0,43,1,43.0
camel,main.resources.archetype-resources.__artifactId__-api.src.main.java.api,2,4,39,43,4,21.5
camel,test.java.org.apache.camel.converter.crypto,1,0,43,43,1,43.0
camel,test.java.org.apache.camel.component.weather,1,0,43,43,1,43.0
camel,test.java.org.apache.camel.component.quartz2,1,0,43,43,1,43.0
camel,org.apache.camel.component.mongodb.processor.idempotent.integration,9,22,21,43,1,4.777777777777778
camel,generated.resources.org.apache.camel.util.xml,1,0,42,42,1,42.0
camel,generated.java.org.apache.camel.util.xml,1,0,42,42,1,42.0
camel,test.java.org.apache.camel.component.cxf.wssecurity.camel,1,0,42,42,1,42.0
camel,test.java.org.apache.camel.itest.spring30,1,0,42,42,1,42.0
camel,test.java.org.apache.camel.itest.osgi.spring.bean,1,0,42,42,1,42.0
camel,test.java.org.apache.camel.component.quickfixj.examples.util,1,0,42,42,1,42.0
camel,test.java.org.apache.camel.hamcrest,1,0,42,42,1,42.0
camel,org.apache.camel.component.jms.integration.spring.tx.support,1,18,24,42,3,42.0
camel,org.apache.camel.spring.example.test1,7,34,8,42,2,6.0
camel,test.java.org.apache.camel.cdi.converter,1,0,42,42,1,42.0
camel,org.apache.camel.component.kamelet.utils.serialization.gson,1,41,0,41,1,41.0
camel,org.apache.camel.dsl.xml.io.support,1,41,0,41,1,41.0
camel,test.java.org.apache.camel.spring.util,1,0,41,41,1,41.0
camel,org.apache.camel.itest.typeconverter,2,40,1,41,1,20.5
camel,org.apache.camel.dsl.xml.jaxb.support,1,41,0,41,1,41.0
camel,test.java.org.apache.camel.component.servlet.rest,1,0,41,41,1,41.0
camel,test.java.org.apache.camel.component.restlet.converter,1,0,41,41,1,41.0
camel,test.java.org.apache.camel.component.couchbase,1,0,41,41,1,41.0
camel,org.apache.camel.spring.issues.contextscan2,10,19,22,41,2,4.1
camel,org.apache.camel.test.blueprint.scan2,4,38,3,41,1,10.25
camel,org.apache.camel.component.influxdb2.enums,1,41,0,41,1,41.0
camel,org.apache.camel.language.spel.bean,2,39,1,40,1,20.0
camel,test.java.org.apache.camel.example.bam,1,0,40,40,1,40.0
camel,org.apache.camel.component.github.event,2,39,1,40,1,20.0
camel,test.java.org.apache.camel.itest.typeconverter,1,0,39,39,1,39.0
camel,test.java.org.apache.camel.component.quickfix.example,1,0,39,39,1,39.0
camel,test.java.org.apache.camel.component.debezium,1,0,39,39,1,39.0
camel,org.apache.camel.component.cache.factory,2,36,3,39,1,19.5
camel,org.apache.camel.test.stub.camel,2,37,2,39,1,19.5
camel,org.apache.camel.refier,1,39,0,39,1,39.0
camel,org.apache.camel.test.infra.kafka.common,6,35,3,38,2,6.333333333333333
camel,org.apache.camel.component.bonita.util,4,35,3,38,1,9.5
camel,org.apache.camel.component.docker.exception,3,36,2,38,1,12.666666666666666
camel,org.apache.camel.test.infra.opensearch.common,5,36,2,38,1,7.6
camel,test.java.org.apache.camel.example.jmstofile,1,0,38,38,1,38.0
camel,generated.java.org.apache.camel.impl.converter,1,0,38,38,1,38.0
camel,org.apache.camel.test.infra.ollama.commons,3,36,2,38,2,12.666666666666666
camel,org.apache.camel.component.azure.storage.queue.operations.integration,4,23,15,38,2,9.5
camel,org.apache.camel.spring.dataformat,4,33,5,38,1,9.5
camel,org.apache.camel.component.azure.schema.registry,1,37,0,37,1,37.0
camel,org.apache.camel.spring.issues.contextscan,10,17,20,37,2,3.7
camel,org.apache.camel.test.infra.hivemq.common,1,37,0,37,1,37.0
camel,test.java.org.apache.camel.cdi.expression,1,0,37,37,1,37.0
camel,org.apache.camel.component.cxf.transport.message,5,16,21,37,3,7.4
camel,test.java.org.apache.camel.component.hl7,1,0,37,37,1,37.0
camel,org.apache.camel.component.gae,1,36,0,36,1,36.0
camel,test.java.org.apache.camel.spring.javaconfig.config,1,0,36,36,1,36.0
camel,test.java.org.apache.camel.component.gae,1,0,36,36,1,36.0
camel,test.java.org.apache.camel.test.blueprint.scan2,1,0,35,35,1,35.0
camel,org.apache.camel.test.infra.milvus.common,4,32,3,35,1,8.75
camel,org.apache.camel.test.infra.rocketmq.common,2,33,2,35,1,17.5
camel,org.apache.camel.processor.transformer.custom,3,33,2,35,1,11.666666666666666
camel,org.apache.camel.test.infra.elasticsearch.common,4,35,0,35,1,8.75
camel,org.apache.camel.example.reactive.streams.app,3,2,33,35,1,11.666666666666666
camel,org.apache.camel.spring.config.routebuilder,3,32,2,34,1,11.333333333333334
camel,com.notnoop.apns.internal,4,31,3,34,1,8.5
camel,org.apache.camel.component.kafka.transform,1,17,17,34,16,34.0
camel,org.apache.camel.test.infra.infinispan.common,3,34,0,34,1,11.333333333333334
camel,org.apache.camel.spring.config.routebuilder.my,3,31,3,34,1,11.333333333333334
camel,org.apache.camel.test.infra.google.pubsub.common,2,32,1,33,1,16.5
camel,org.apache.camel.test.infra.hashicorp.vault.common,3,32,1,33,1,11.0
camel,org.apache.camel.test.infra.minio.common,3,33,0,33,2,11.0
camel,org.apache.camel.test.infra.postgres.common,2,33,0,33,1,16.5
camel,org.apache.camel.test.infra.rabbitmq.common,2,32,0,32,1,16.0
camel,generated.java.org.apache.camel.dataformat.any23,1,0,32,32,1,32.0
camel,org.apache.camel.swagger.spi,1,32,0,32,1,32.0
camel,test.java.org.apache.camel.pgevent.integration,1,0,32,32,1,32.0
camel,generated.java.org.apache.camel.component.johnzon,1,0,32,32,1,32.0
camel,test.java.org.apache.camel.component.test,1,0,32,32,1,32.0
camel,org.apache.camel.test.blueprint.builder.my,2,31,1,32,1,16.0
camel,test.java.org.apache.camel.component.iec60870,1,0,32,32,1,32.0
camel,org.apache.camel.test.blueprint.builder,2,31,1,32,1,16.0
camel,org.apache.camel.component.zookeepermaster.integration,5,19,13,32,1,6.4
camel,test.java.org.apache.camel.example.docs,1,0,31,31,1,31.0
camel,test.java.org.apache.camel.example.spring.javaconfig,1,0,31,31,1,31.0
camel,org.apache.camel.test.infra.fhir.common,2,31,0,31,1,15.5
camel,org.apache.camel.test.infra.microprofile.lra.common,1,31,0,31,1,31.0
camel,test.java.org.apache.camel.example.micrometer,1,0,31,31,1,31.0
camel,test.java.org.apache.camel.example.etl,1,0,31,31,1,31.0
camel,org.apache.camel.test.infra.couchbase.common,3,31,0,31,2,10.333333333333334
camel,org.apache.camel.test.infra.keycloak.common,1,30,0,30,1,30.0
camel,generated.java.org.apache.camel.dataformat.tagsoup,1,0,30,30,1,30.0
camel,org.apache.camel.test.infra.mongodb.common,4,29,1,30,1,7.5
camel,org.apache.camel.test.infra.xmpp.common,2,30,0,30,1,15.0
camel,org.apache.camel.test.infra.couchdb.common,2,30,0,30,1,15.0
camel,org.foo.search,1,30,0,30,1,30.0
camel,test.java.org.apache.camel.blueprint.test.builder,1,0,30,30,1,30.0
camel,org.apache.camel.test.infra.redis.common,2,30,0,30,1,15.0
camel,test.java.org.apache.camel.test.blueprint.scan,1,0,30,30,1,30.0
camel,test.java.org.apache.camel.example.spring,1,0,30,30,1,30.0
camel,org.apache.camel.test.infra.qdrant.common,1,30,0,30,1,30.0
camel,test.java.org.apache.camel.test.blueprint.builder.my,1,0,30,30,1,30.0
camel,test.java.org.apache.camel.test.blueprint.builder,1,0,30,30,1,30.0
camel,org.apache.camel.test.infra.consul.common,2,29,0,29,1,14.5
camel,org.apache.camel.test.infra.jetty.common,1,29,0,29,1,29.0
camel,org.apache.camel.test.infra.neo4j.common,1,29,0,29,1,29.0
camel,org.apache.camel.test.infra.hdfs.v2.common,2,27,2,29,1,14.5
camel,it.client-validation.src.main.java.com.example,1,0,29,29,1,29.0
camel,org.apache.camel.test.infra.weaviate.common,1,29,0,29,1,29.0
camel,org.apache.camel.test.infra.pinecone.common,1,29,0,29,1,29.0
camel,org.apache.camel.test.infra.openldap.common,1,29,0,29,1,29.0
camel,org.apache.camel.test.infra.arangodb.common,2,29,0,29,1,14.5
camel,org.apache.camel.impl.scan.test.b,1,29,0,29,1,29.0
camel,org.apache.camel.component.springrabbit.test.infra.services,1,29,0,29,1,29.0
camel,org.apache.camel.test.infra.tensorflow.serving.common,2,27,1,28,1,14.0
camel,org.apache.camel.test.infra.cassandra.common,2,28,0,28,1,14.0
camel,test.resources.jbang.it.from-source-dir,1,28,0,28,1,28.0
camel,test.java.org.apache.camel.spring.dataformat,1,0,28,28,1,28.0
camel,test.java.com.notnoop.apns.internal,1,0,28,28,1,28.0
camel,test.java.org.apache.camel.test.infra.solr.common,1,0,28,28,1,28.0
camel,org.apache.camel.test.infra.pulsar.common,2,28,0,28,1,14.0
camel,org.apache.camel.loanbroker.queue.version.bank,1,10,18,28,1,28.0
camel,main.resources.org.apache.camel.component.jms,1,0,28,28,1,28.0
camel,org.apache.camel.test.infra.ftp.common,1,28,0,28,1,28.0
camel,org.apache.camel.component.jms.integration.mqseries,1,14,14,28,3,28.0
camel,a.b.c,3,26,2,28,1,9.333333333333334
camel,generated.java.org.apache.camel.dataformat.swift.mt,1,0,28,28,1,28.0
camel,org.apache.camel.test.infra.messaging.common,1,27,0,27,1,27.0
camel,org.apache.camel.component.huaweicloud.frs.real,1,18,9,27,9,27.0
camel,test.java.org.apache.camel.spring.processor.onexception,1,0,27,27,1,27.0
camel,test.java.org.apache.camel.test.infra.etcd.common,1,0,27,27,1,27.0
camel,org.apache.camel.impl.scan.test.a,1,27,0,27,1,27.0
camel,org.apache.camel.test.infra.mosquitto.common,2,27,0,27,1,13.5
camel,test.java.org.apache.camel.test.infra.nsq.common,1,0,27,27,1,27.0
camel,org.apache.camel.test.infra.nsq.common,1,27,0,27,1,27.0
camel,org.apache.camel.test.infra.docling.common,1,27,0,27,1,27.0
camel,generated.java.org.apache.camel.component.smooks,1,0,27,27,1,27.0
camel,org.apache.camel.test.infra.chatscript.common,2,27,0,27,1,13.5
camel,org.apache.camel.test.infra.triton.common,1,27,0,27,1,27.0
camel,org.apache.camel.test.infra.zookeeper.common,2,27,0,27,1,13.5
camel,org.apache.camel.test.infra.etcd.common,2,27,0,27,1,13.5
camel,org.apache.camel.test.infra.torchserve.common,1,27,0,27,1,27.0
camel,org.apache.camel.test.infra.jdbc.common,1,26,0,26,1,26.0
camel,org.apache.camel.example.cdi.one.weld,1,16,10,26,1,26.0
camel,generated.java.org.apache.camel.dataformat.beanio,1,0,26,26,1,26.0
camel,org.apache.camel.test.infra.smb.common,1,26,0,26,1,26.0
camel,org.apache.camel.dsl.jbang.core.commands.kubernetes.support,4,12,14,26,6,6.5
camel,org.apache.camel.impl.model,6,16,10,26,2,4.333333333333333
camel,org.apache.camel.ai,3,26,0,26,1,8.666666666666666
camel,org.apache.camel.test.infra.hbase.common,1,25,0,25,1,25.0
camel,org.apache.camel.test.infra.hazelcast.common,1,25,0,25,1,25.0
camel,test.java.org.apache.camel.test.infra.hdfs.v2.common,1,0,25,25,1,25.0
camel,org.apache.camel.component.jms.integration.spring.polling,2,14,11,25,1,12.5
camel,org.apache.camel.component.clickup.model.errors,1,25,0,25,1,25.0
camel,test.java.org.apache.camel.test.infra.hbase.common,1,0,25,25,1,25.0
camel,org.apache.camel.test.infra.ignite.common,1,25,0,25,1,25.0
camel,org.apache.camel.itest.cdi.properties,3,21,4,25,3,8.333333333333334
camel,org.apache.camel.component.aws2.transcribe.client,1,24,0,24,1,24.0
camel,generated.java.org.apache.camel.dataformat.soap,1,0,24,24,1,24.0
camel,org.apache.camel.itest.karaf.activator,1,6,18,24,2,24.0
camel,org.apache.camel.itest.osgi.core.direct,2,14,10,24,1,12.0
camel,org.apache.camel.component.mongodb.verifier.integration,6,8,14,22,1,3.6666666666666665
camel,org.apache.camel.component.jms.integration.tx,2,12,10,22,4,11.0
camel,org.apache.camel.component.aws2.bedrock.runtime.client,2,15,7,22,2,11.0
camel,org.apache.camel.dataformat.smooks.gender,1,22,0,22,1,22.0
camel,org.apache.camel.component.cxf.transport.header,4,10,10,20,3,5.0
camel,org.apache.camel.spring.processor.throttle,2,10,10,20,4,10.0
camel,org.apache.camel.component.jms.issues.error.ncd,2,7,13,20,4,10.0
camel,org.apache.camel.component.jms.integration.polling,1,10,10,20,5,20.0
camel,test.java.org.apache.camel.component.google.storage,1,0,19,19,1,19.0
camel,org.apache.camel.component.etcd.cloud.integration,1,10,8,18,4,18.0
camel,org.apache.camel.component.etcd.integration,2,10,8,18,3,9.0
camel,org.apache.camel.itest.osgi.core.file,2,9,9,18,3,9.0
camel,org.apache.camel.itest.karaf.main,2,8,8,16,2,8.0
camel,test.java.org.apache.camel.component.sql.stored,1,0,15,15,1,15.0
camel,org.apache.camel.processor.converter.custom,3,9,5,14,2,4.666666666666667
camel,org.apache.camel.test.infra.nats.common,2,9,5,14,1,7.0
camel,org.apache.camel.component.jms.support,1,7,7,14,6,14.0
camel,org.apache.camel.component.nsq.integration,1,8,6,14,3,14.0
camel,org.apache.camel.component.google.sheets.integration,1,8,6,14,2,14.0
camel,org.apache.camel.core.osgi.tracker,1,6,6,12,3,12.0
camel,org.apache.camel.example.cdi.two.weld,1,8,4,12,1,12.0
camel,org.apache.camel.component.jms.integration.spring.tx.security,1,7,5,12,1,12.0
camel,org.apache.camel.component.jms.integration.spring.bind,1,6,5,11,2,11.0
camel,org.apache.camel.itest.osgi.core.packages,2,5,5,10,2,5.0
camel,org.apache.camel.cloudevents,2,5,5,10,3,5.0
camel,org.apache.camel.catalog.util,1,5,5,10,5,10.0
camel,org.apache.camel.spring.scan.c,2,5,5,10,2,5.0
camel,org.apache.camel.component.cxf.spring.transport,2,5,5,10,4,5.0
camel,org.apache.camel.itest.osgi.cxf.jaxrs.testbean,1,5,5,10,5,10.0
camel,org.apache.camel.component.salesforce.internal.datetime,1,4,5,9,3,9.0
camel,org.apache.camel.component.exec.internal,1,8,1,9,1,9.0
camel,org.apache.camel.component.redis.processor.aggregate.integration,2,5,4,9,2,4.5
camel,org.apache.camel.component.mail.microsoft.authenticator,2,7,2,9,1,4.5
camel,org.apache.camel.component.stitch.integration,2,6,3,9,1,4.5
camel,org.apache.camel.spring.scan.a,2,3,5,8,1,4.0
camel,org.apache.camel.test.main.junit5.legacy.custom,1,4,4,8,2,8.0
camel,org.apache.camel.spring.scan.b,2,4,4,8,1,4.0
camel,org.apache.camel.dsl.xml.jaxb.definition.cdi,2,4,4,8,1,4.0
camel,org.apache.camel.itest.osgi.core.validator,2,4,4,8,1,4.0
camel,org.apache.camel.component.azure.eventhubs.integration.operations,2,6,2,8,1,4.0
camel,org.apache.camel.spring.javaconfig.config,4,5,2,7,1,1.75
camel,org.apache.camel.component.stitch.client.integration,1,6,1,7,1,7.0
camel,org.apache.camel.component.langchain4j.chat.openai,2,3,3,6,1,3.0
camel,org.apache.camel.endpointdsl.support,1,4,2,6,1,6.0
camel,org.apache.camel.spring.boot.duplicatedrouteid,1,3,3,6,1,6.0
camel,org.apache.camel.spring.boot.zlast,1,4,2,6,2,6.0
camel,org.apache.camel.test.infra.core.annotations,1,3,3,6,3,6.0
camel,org.apache.camel.component.jetty.springboot,1,3,3,6,2,6.0
camel,org.apache.camel.component.stitch.operations.integration,1,4,1,5,1,5.0
camel,org.apache.camel.itest.osgi.seda,1,3,2,5,1,5.0
camel,org.apache.camel.component.jms.validator,1,3,2,5,1,5.0
camel,org.apache.camel.itest.osgi.spring.validator,1,2,2,4,1,4.0
camel,org.apache.camel.component.hdfs2.osgi,2,2,2,4,1,2.0
camel,org.apache.camel.meta,2,2,2,4,1,2.0
camel,org.apache.camel.itest.osgi.direct,1,2,1,3,1,3.0
camel,org.apache.camel.component.langchain4j.embeddings.openai,1,1,1,2,1,2.0
camel,org.apache.camel.component.langchain4j.chat.huggingface,1,1,1,2,1,2.0
camel,org.apache.camel.component.langchain4j.embeddings.huggingface,1,1,1,2,1,2.0
camel,org.apache.camel.support.processor.claimcheck,1,1,1,2,1,2.0
camel,org.apache.camel.component.rxjava.engine.support,1,1,1,2,1,2.0
camel,org.apache.camel.component.aws2.ddb.transform.serialization.gson,1,1,1,2,1,2.0
